"","Necrosis","Diabetes.Mellitus","Hypertension","Recurrence","Myocardial.Ischemia","Hemorrhage","Hypersensitivity","Stroke","Obesity","Pneumonia","Arthritis","Fibrosis","Coronary.Disease","Infarction","COVID.19","Heart.Failure","Lymphoma","Overweight","Tuberculosis","Hepatitis","Shock","Myocardial.Infarction","Neoplasm.Metastasis","Overnutrition","Dementia","Hypersensitivity..Immediate","Thrombosis","Gastroenteritis","Embolism.and.Thrombosis","Arrhythmias..Cardiac","Fever","Anemia","Poisoning","Trauma..Nervous.System","Pneumonia..Viral","Laboratory.Infection","Renal.Insufficiency","Asthma","Sepsis","Arteriosclerosis","Carcinogenesis","Sarcoma","Edema","Diabetes.Mellitus..type.2","Sclerosis","Hypoxia","Respiratory.Hypersensitivity","Craniocerebral.Trauma","Protein.Deficiency","Ulcer","Epilepsy","Heart.Defects..Congenital","Atherosclerosis","Weight.Loss","Aneurysm","Arthritis..Rheumatoid","Hepatitis..Viral..Human","Malnutrition","Genetic.Predisposition.to.Disease","Cysts","Melanoma","Rupture","Systemic.Inflammatory.Response.Syndrome","Insulin.Resistance","Neoplasm.Recurrence..Local","Chronic.Pain","Carcinoma..Hepatocellular","Atrophy","Brain.Ischemia","Cross.Infection","Liver.Cirrhosis","Seizures","Renal.Insufficiency..Chronic","Mycoses","Dermatitis","Hypertrophy","Alzheimer.Disease","Fatigue","Helminthiasis","Diarrhea","Leukemia..Myeloid","Carcinoma..Small.Cell","Adenoma","Pain..Postoperative","Hyperplasia","Birth.Weight","Lymphoma..Non.Hodgkin","Kidney.Failure..Chronic","Tauopathies","Vasculitis","Paralysis","Nevi.and.Melanomas","Fistula","Intellectual.Disability","Glioma","Cardiomyopathies","Burns","Infertility","Osteoarthritis","Surgical.Wound","Hepatitis.B","Embolism","Abdominal.Pain","Malaria","Multiple.Sclerosis","Hyperinsulinism","Acute.Pain","Headache","Atrial.Fibrillation","Lymphatic.Metastasis","Hepatitis..Chronic","Cardiac.Conduction.System.Disease","Osteoporosis","Metabolic.Syndrome","Hernia","Hearing.Loss","Weight.Gain","Hepatitis.C","Fatty.Liver","Hypertension..Renal","Tuberculosis..Pulmonary","Parkinson.Disease","Ischemic.Stroke","Small.Cell.Lung.Carcinoma","Pulmonary.Disease..Chronic.Obstructive","Venous.Thrombosis","Neoplasm.Invasiveness","Acquired.Immunodeficiency.Syndrome","Chest.Pain","Colitis","Alcoholism","Vomiting","Lymphoma..B.Cell","Lung.Injury","Leukemia..Lymphoid","Abscess","Brain.Death","Dyskinesias","Leukemia..Myeloid..Acute","Peptic.Ulcer","Diabetes.Mellitus..Type.1","Thromboembolism","Nephritis","Iatrogenic.Disease","Suppuration","Wound.Infection","Dyslipidemias","Back.Pain","Synucleinopathies","Anemia..Hemolytic","Cell.Transformation..Neoplastic","Tachycardia","Thrombocytopenia","Body.Temperature.Changes","Drug.Hypersensitivity","Hyperglycemia","Carcinoma..Bronchogenic","Carcinoma..Non.Small.Cell.Lung","Liver.Failure","Meningitis","Glaucoma","Lupus.Erythematosus..Systemic","Ventricular.Dysfunction","Dyssomnias","Cataract","Intracranial.Hemorrhages","Metaplasia","Avitaminosis","Hypertension..Pulmonary","Acute.Kidney.Injury","Nausea","Aortic.Valve.Disease","Respiratory.Insufficiency","Pancreatitis","Aortic.Aneurysm","Encephalitis","Infant.Death","Hypotension","Hypersensitivity..Delayed","Heart.Arrest","Influenza..Human","Cancer.Pain","Neutropenia","Reperfusion.Injury","Critical.Illness","Hematoma","Infertility..Female","Hyperlipidemias","Apnea","Proteinuria","Dyspnea","Cerebral.Hemorrhage","Death..Sudden","Pulmonary.Heart.Disease","Ventricular.Dysfunction..Left","Sexual.Infantilism","Cough","Cadaver","Bone.Resorption","Water.Electrolyte.Imbalance","Ocular.Hypertension","Dental.Caries","Calculi","Diabetes.Mellitus..Experimental","Premature.Birth","Emergencies","Pulmonary.Embolism","Carcinoma..Renal.Cell","Retinal.Degeneration","Adenocarcinoma.of.Lung","Prosthesis.Failure","Psoriasis","Myosarcoma","Paraproteinemias","Glomerulonephritis","Multiple.Myeloma","Gastrointestinal.Hemorrhage","Cardiomegaly","Cystic.Fibrosis","Brain.Infarction","Intestinal.Obstruction","Coma","Aortic.Valve.Stenosis","Respiratory.Distress.Syndrome","Heart.Block","Cerebral.Infarction","Pulmonary.Fibrosis","Neovascularization..Pathologic","Surgical.Wound.Infection","Colitis..Ulcerative","Foreign.Bodies","Aneuploidy","Acidosis","Diabetic.Angiopathies","Infertility..Male","Skin.Ulcer","Hypoglycemia","Carcinoma.in.Situ","Femoral.Fractures","Anemia..Hemolytic..Congenital","Severe.Acute.Respiratory.Syndrome","Tooth.Demineralization","Blood.Loss..Surgical","Herpes.Simplex","Coronary.Stenosis","Granuloma","Fetal.Weight","Blindness","Lymphoma..T.Cell","Hyperthyroidism","Muscle.Weakness","Pneumonia..Bacterial","Bacteremia","Angina.Pectoris","Confusion","Glioblastoma","Hemoglobinopathies","Body.Remains","Hemolysis","Ataxia","Calcinosis","Rhinitis","Hypothyroidism","Ascites","Polyps","Urinary.Incontinence","Leukopenia","Hodgkin.Disease","Chromosome.Deletion","Hypothermia","Erythema","Astrocytoma","Hypercholesterolemia","Fetal.Death","Brain.Damage..Chronic","Osteoarthritis..Knee","Crohn.Disease","Periodontitis","Hypertension..Pregnancy.Induced","Squamous.Cell.Carcinoma.of.Head.and.Neck","Neuroblastoma","Low.Back.Pain","Unconsciousness","Jaundice","Deafness","Ventricular.Fibrillation","Translocation..Genetic","Ventricular.Outflow.Obstruction","Eclampsia","Hip.Fractures","Tachycardia..Ventricular","Joint.Dislocations","Carcinoma..Ductal","Endocarditis","Urolithiasis","Peritonitis","Spondylitis","Occupational.Stress","Cicatrix","Bronchitis","Abortion..Spontaneous","Cholestasis","Dehydration","Angiolymphoid.Hyperplasia.with.Eosinophilia","Diabetic.Retinopathy","Hemangioma","Down.Syndrome","Wounds..Nonpenetrating","Postoperative.Hemorrhage","Nerve.Degeneration","Uveitis","Dermatitis..Contact","Osteosarcoma","Goiter","Hyperthermia","Dizziness","Airway.Obstruction","Acute.Coronary.Syndrome","Carcinoma..Papillary","Malaria..Falciparum","Acid.Base.Imbalance","Wounds..Penetrating","Shock..Septic","Candidiasis","Multiple.Trauma","Leukemia..B.Cell","Cholelithiasis","Urinary.Calculi","Pre.Eclampsia","Macular.Degeneration","Stomach.Ulcer","Emphysema","Clinical.Deterioration","Sleep.Apnea..Obstructive","Syphilis","Motor.Neuron.Disease","Death..Sudden..Cardiac","Otitis","Malocclusion","Leukemia..Experimental","Anorexia","Eosinophilia","Starvation","Hernia..Abdominal","Neck.Pain","Heart.Septal.Defects","Vitamin.D.Deficiency","Purpura","Hydrocephalus","Coccidiosis","Neuralgia","Intracranial.Aneurysm","Meningitis..Bacterial","Encephalitis..Viral","Peripheral.Arterial.Disease","Gastroesophageal.Reflux","Hypertension..Portal","Amyloidosis","Hearing.Loss..Sensorineural","Essential.Hypertension","Subarachnoid.Hemorrhage","Leukoencephalopathies","Leukemia..T.Cell","Obstetric.Labor..Premature","Constriction..Pathologic","Pleural.Effusion","Rhinitis..Allergic","Venous.Thromboembolism","Cerebral.Palsy","Hypertrophy..Left.Ventricular","Joint.Instability","Carcinoma..Large.Cell","Hepatitis.C..Chronic","Prolapse","Hypoxia..Brain","Osteomyelitis","Musculoskeletal.Pain","Dermatitis..Atopic","Pulmonary.Edema","Fatty.Liver..Alcoholic","Sarcoidosis","Chemical.and.Drug.Induced.Liver.Injury","Hepatic.Insufficiency","Hyperparathyroidism","Neural.Tube.Defects","Encephalomyelitis","Precursor.Cell.Lymphoblastic.Leukemia.Lymphoma","Aneurysm..Dissecting","Sexual.Dysfunction..Physiological","Aortic.Aneurysm..Abdominal","Anaphylaxis","Constipation","Hemorrhagic.Fevers..Viral","Amyotrophic.Lateral.Sclerosis","Coronary.Occlusion","Muscular.Atrophy","Duodenal.Ulcer","Otitis.Media","Endometriosis","Gastritis","Digestive.System.Fistula","Hyperbilirubinemia","Osteochondrodysplasias","Zoonoses","Stomatitis","Leishmaniasis","Polyneuropathies","Pregnancy..Ovarian","Lymphoma..Large.B.Cell..Diffuse","Retinal.Detachment","Measles","Infectious.Encephalitis","Brain.Edema","Carcinoma..Basal.Cell","Vitamin.B.Deficiency","Thalassemia","Cleft.Palate","Obesity..Morbid","Pelvic.Pain","Muscular.Dystrophies","Thrombophilia","Keratosis","Pneumothorax","Uremia","Leprosy","Tetanus","Spondylarthritis","Non.alcoholic.Fatty.Liver.Disease","Sinusitis","Systemic.Vasculitis","Learning.Disabilities","Vascular.Fistula","Prostatic.Hyperplasia","Cholera","Myelitis","Dermatomycoses","Scoliosis","Coronary.Thrombosis","Mitral.Valve.Insufficiency","Hepatitis.A","Graft.vs.Host.Disease","Dental.Plaque","ST.Elevation.Myocardial.Infarction","Acute.Lung.Injury","Diabetic.Nephropathies","Celiac.Disease","Menstruation.Disturbances","Schistosomiasis","Heart.Failure..Systolic","Diabetes..Gestational","Bradycardia","Hematuria","Carcinoma..Ductal..Breast","Newcastle.Disease","Spinal.Curvatures","Myopia","Dengue","Food.Hypersensitivity","Ovarian.Cysts","Maternal.Death","Rupture..Spontaneous","Heart.Aneurysm","Carotid.Stenosis","Erectile.Dysfunction","Ischemic.Attack..Transient","Monosomy","Genomic.Instability","Epilepsy..Generalized","Keratitis","Arteritis","Shoulder.Pain","Phlebitis","Spondylarthropathies","Spinal.Fractures","Neuroma","Drug.Eruptions","Endocarditis..Bacterial","Appendicitis","Aneurysm..Ruptured","Anemia..Sickle.Cell","Fractures..Open","Pruritus","Leg.Ulcer","Agranulocytosis","TDP.43.Proteinopathies","Ventricular.Remodeling","Spasm","Uterine.Hemorrhage","Meningioma","Diabetic.Neuropathies","Teratoma","Arteriovenous.Fistula","Obesity..Abdominal","Conjunctivitis","Lymphadenopathy","Plaque..Atherosclerotic","Tremor","Myositis","Limb.Deformities..Congenital","Urticaria","Vascular.Remodeling","Trypanosomiasis","Alopecia","Epilepsies..Partial","Hepatitis.B..Chronic","Cardiomyopathy..Dilated","HIV.Seropositivity","Strabismus","Paraganglioma","Pulmonary.Arterial.Hypertension","Toxoplasmosis","Leiomyoma","Frailty","Myocarditis","Skull.Fractures","Exophthalmos","Scleroderma..Diffuse","Histiocytosis","Kidney.Calculi","Scleroderma..Systemic","Nephrolithiasis","Vision..Low","Nephrotic.Syndrome","Thrombotic.Microangiopathies","Pediatric.Obesity","Neoplasm..Residual","Rheumatic.Fever","Pulmonary.Emphysema","Myocardial.Reperfusion.Injury","Aortic.Aneurysm..Thoracic","Substance.Withdrawal.Syndrome","Transfusion.Reaction","Papilloma","Esophageal.Squamous.Cell.Carcinoma","Eczema","Graves.Disease","Thrombophlebitis","Hemophilia.A","Nephritis..Interstitial","Retinoblastoma","Carcinoma..Transitional.Cell","Liver.Failure..Acute","Cell.Transformation..Viral","Poliomyelitis","Pheochromocytoma","Paraplegia","Chromosome.Duplication","Syncope","Adrenocortical.Hyperfunction","Coinfection","Mitral.Valve.Stenosis","Drug.Overdose","Cardiomyopathy..Hypertrophic","Bites.and.Stings","Remission..Spontaneous","Diverticulum","Pancreatitis..Chronic","Delirium","Latent.Infection","Neurilemmoma","Nevus","Intracranial.Hypertension","Contracture","Nephrosis","Albuminuria","Trisomy","Intracranial.Embolism.and.Thrombosis","Ankylosis","Arthritis..Infectious","Aspergillosis","Internal.Hernia","Dystonia","Hypercalcemia","Multiple.Organ.Failure","Ectoparasitic.Infestations","Mononeuropathies","Pelvic.Infection","Dental.Deposits","Lipidoses","Fetal.Growth.Retardation","Diphtheria","Aortic.Valve.Insufficiency","Anemia..Iron.Deficiency","Arthralgia","Osteonecrosis","Osteoporosis..Postmenopausal","Enteritis","Osteoarthritis..Hip","Epilepsy..Temporal.Lobe","Retinitis","Splenomegaly","Panuveitis","Echinococcosis","Thyroiditis","Varicella.Zoster.Virus.Infection","Tooth.Loss","Leukemia..Myelogenous..Chronic..BCR.ABL.Positive","Gout","Pneumoconiosis","Esophagitis","Heavy.Metal.Poisoning","Polycystic.Ovary.Syndrome","Sarcoma..Experimental","Hernia..Diaphragmatic","Viremia","Nociceptive.Pain","Purpura..Thrombocytopenic","Spondylitis..Ankylosing","Cholecystitis","Asphyxia","Leukemia..Lymphocytic..Chronic..B.Cell","Anemia..Hypochromic","Heart.Failure..Diastolic","Xerostomia","Cleft.Lip","Melanoma..Experimental","Varicose.Veins","Facial.Pain","Chagas.Disease","Enterocolitis","Fibroma","Cholangitis","Abdomen..Acute","Breast.Carcinoma.In.Situ","Hyperalgesia","Vertigo","Sprains.and.Strains","Pregnancy..Ectopic","Glaucoma..Open.Angle","Iron.Overload","Adenocarcinoma..Papillary","Tibial.Fractures","Carcinoma..Neuroendocrine","Liver.Cirrhosis..Alcoholic","Gallstones","Intracranial.Thrombosis","Infarction..Middle.Cerebral.Artery","Dent.Disease","Hypogonadism","Myasthenia.Gravis","Pain..Referred","Intervertebral.Disc.Displacement","Aortic.Rupture","Anemia..Aplastic","Mesothelioma","Abdominal.Abscess","Aphasia","Hip.Dislocation","Pyelonephritis","Pregnancy..Abdominal","Gonorrhea","Arthritis..Experimental","Chorea","Angina..Unstable","Foot.Deformities","Intestinal.Fistula","Heart.Septal.Defects..Atrial","Glucose.Intolerance","Pressure.Ulcer","Heart.Septal.Defects..Ventricular","Dysostoses","Cervical.Intraepithelial.Neoplasia","Uveitis..Anterior","Dwarfism","Cerebellar.Ataxia","Hernia..Inguinal","Respiratory.Distress.Syndrome..Newborn","Pharyngitis","Spinal.Cord.Compression","Intestinal.Perforation","Herpes.Zoster","Laminopathies","Neuritis","Hallucinations","Cholangiocarcinoma","Dermatitis..Allergic.Contact","Ureteral.Obstruction","Diabetic.Foot","Shock..Surgical","Fractures..Multiple","Adrenal.Insufficiency","Paresis","Intestinal.Polyps","Leukocytosis","Hamartoma","Sjogren.s.Syndrome","Amenorrhea","Fibrosarcoma","Oral.Hemorrhage","Shock..Cardiogenic","Nasopharyngeal.Carcinoma","Neurofibroma","Hyperpigmentation","Burnout..Professional","Ciliopathies","Filariasis","Huntington.Disease","Osteoporotic.Fractures","Wounds..Gunshot","Lymphedema","Hydronephrosis","Environmental.Illness","Hypertriglyceridemia","Dementia..Vascular","Ventricular.Dysfunction..Right","Substance.Abuse..Intravenous","Bone.Cysts","Mastitis","Aortic.Stenosis..Subvalvular","Rheumatic.Heart.Disease","Shock..Hemorrhagic","Sleepiness","Urinary.Retention","Dysentery","Rickets","Thyroid.Cancer..Papillary","Sarcopenia","Coronary.Restenosis","Rabies","End.Stage.Liver.Disease","Cholestasis..Intrahepatic","Hypotrichosis","Irritable.Bowel.Syndrome","Urinary.Incontinence..Stress","Disseminated.Intravascular.Coagulation","Hypocalcemia","Hyperemia","Rubella","Fracture.Dislocation","Mental.Retardation..X.Linked","Pericarditis","Dysbiosis","Tissue.Adhesions","Arthritis..Reactive","Bronchitis..Chronic","Gangrene","Vaccinia","beta.Thalassemia","Periodontal.Atrophy","Median.Neuropathy","Hepatic.Encephalopathy","Hemiplegia","Facial.Paralysis","Hyponatremia","Lead.Poisoning","Foot.Ulcer","Thinness","Tendinopathy","Perinatal.Death","Sphingolipidoses","Colonic.Polyps","Coronary.Aneurysm","Carcinoid.Tumor","Femoral.Neck.Fractures","Obesity..Maternal","Lipoma","Encephalitis..Arbovirus","Synovitis","Heart.Rupture","Polycythemia","Intracranial.Hemorrhage..Traumatic","Cardiotoxicity","Status.Epilepticus","Cystitis","Common.Cold","Ileus","Hypokalemia","Uterine.Cervical.Dysplasia","Pelvic.Organ.Prolapse","Pulmonary.Infarction","Eye.Hemorrhage","Tinnitus","Brucellosis","Arthritis..Juvenile","Pericardial.Effusion","Venous.Insufficiency","Pelvic.Inflammatory.Disease","Crystal.Arthropathies","Adenocarcinoma..Mucinous","Pyelitis","Brain.Injury..Chronic","Rhabdomyosarcoma","Tobacco.Use.Disorder","Gingivitis","Liver.Cirrhosis..Biliary","Respiratory.Sounds","Cardiac.Output..Low","Macular.Edema","Bronchiectasis","Alexander.Disease","Arrhythmia..Sinus","Atrioventricular.Block","Smooth.Muscle.Tumor","Ophthalmoplegia","Hyperpituitarism","Alveolar.Bone.Loss","Radius.Fractures","Sleep.Deprivation","Postmortem.Changes","Dyspepsia","Bronchiolitis","Intracranial.Embolism","Lyme.Disease","Gonadal.Dysgenesis","Pregnancy..Prolonged","Vascular.Calcification","Bundle.Branch.Block","Fractures..Compression","Encephalomyelitis..Autoimmune..Experimental","Cellulitis","Amebiasis","Fractures..Stress","Aneurysm..False","Rhinitis..Allergic..Seasonal","Esophageal.and.Gastric.Varices","Amnesia","Hypercapnia","Carcinoma..Pancreatic.Ductal","Primary.Dysautonomias","Polyradiculoneuropathy","Acne.Vulgaris","Pulmonary.Valve.Stenosis","Thyroiditis..Autoimmune","Idiopathic.Pulmonary.Fibrosis","Nervous.System.Autoimmune.Disease..Experimental","Warts","Vaginitis","Tinea","Brain.Concussion","Embryo.Loss","Fractures..Closed","Dilatation..Pathologic","Typhoid.Fever","Kyphosis","Cushing.Syndrome","Neoplastic.Cells..Circulating","Urethral.Obstruction","Hemoptysis","Retinitis.Pigmentosa","Multiple.Sclerosis..Relapsing.Remitting","Lymphoma..T.Cell..Cutaneous","Pregnancy.in.Diabetics","Graft.Occlusion..Vascular","Wilms.Tumor","Alcoholic.Intoxication","Acneiform.Eruptions","Tachycardia..Supraventricular","Tuberculosis..Multidrug.Resistant","Astigmatism","Leishmaniasis..Visceral","Fecal.Incontinence","Polymyositis","Fibromyalgia","Cholecystolithiasis","Hyperparathyroidism..Secondary","Liver.Abscess","Muscle.Hypertonia","Carcinoma..Ovarian.Epithelial","Hypoxia.Ischemia..Brain","Muscular.Dystrophy..Duchenne","Ductus.Arteriosus..Patent","Polyploidy","Osteolysis","Empyema","Lymphoma..Follicular","Arthritis..Psoriatic","Lupus.Nephritis","Hypopigmentation","Nasal.Obstruction","Flushing","Stillbirth","Neurofibromatoses","Tetralogy.of.Fallot","Spinal.Stenosis","Mouth..Edentulous","Focal.Infection","Lymphopenia","Mucinoses","Retinal.Neovascularization","Hyperparathyroidism..Primary","Neonatal.Sepsis","Hemorrhagic.Stroke","Burkitt.Lymphoma","Hepatitis..Animal","Postpartum.Hemorrhage","Leishmaniasis..Cutaneous","Antiphospholipid.Syndrome","Fetal.Distress","Yang.Deficiency","Optic.Neuritis","Leiomyosarcoma","Hematoma..Subdural","Osteitis","Lymphadenitis","Hepatomegaly","Colic","Paresthesia","Hashimoto.Disease","Histiocytosis..Non.Langerhans.Cell","Sarcoma..Kaposi","Sudden.Infant.Death","Anti.Neutrophil.Cytoplasmic.Antibody.Associated.Vasculitis","Hepatitis..Autoimmune","Muscle.Spasticity","Intracranial.Arteriosclerosis","Microcephaly","Acute.Chest.Syndrome","Diplopia","Pneumonia..Aspiration","Synostosis","Guillain.Barre.Syndrome","Dermatitis..Occupational","Carpal.Tunnel.Syndrome","Hernia..Ventral","Dermatomyositis","Brain.Abscess","Thyroid.Nodule","Erythroblastosis..Fetal","Cachexia","Pneumonia..Pneumocystis","Ankle.Fractures","Facial.Neuralgia","Microsatellite.Instability","Foot.and.Mouth.Disease","Hypopituitarism","Cold.Injury","Histiocytosis..Langerhans.Cell","Hyperphagia","Thymoma","Germinoma","Gliosis","Carcinoma..Ehrlich.Tumor","Poland.Syndrome","Mania","Ossification..Heterotopic","Angina..Stable","Mental.Fatigue","Out.of.Hospital.Cardiac.Arrest","Ketosis","Mumps","Humeral.Fractures","Mucositis","Fat.Necrosis","Margins.of.Excision","Depression..Postpartum","Vitamin.B.12.Deficiency","Telangiectasis","Retinal.Dystrophies","Chromosomal.Instability","Plague","Postoperative.Nausea.and.Vomiting","Hyperlipoproteinemias","Intussusception","Schistosomiasis.mansoni","Meningoencephalitis","Aortic.Coarctation","Diabetes.Insipidus","Bulimia","Chronic.Periodontitis","Adenomatous.Polyps","Esophageal.Stenosis","Cardiac.Output..High","Leukemia..Promyelocytic..Acute","Intestinal.Polyposis","Mesothelioma..Malignant","Periodontal.Pocket","Surgical.Wound.Dehiscence","Intervertebral.Disc.Degeneration","Cryptococcosis","Lichenoid.Eruptions","Optic.Atrophy","Pemphigus","Myoclonus","Turner.Syndrome","Hyperventilation","Endophthalmitis","Neurofibromatosis.1","Ataxia.Telangiectasia","Foreign.Body.Reaction","Adrenogenital.Syndrome","Gas.Poisoning","Long.QT.Syndrome","Fractures..Ununited","Acromegaly","Renal.Artery.Obstruction","Pain..Intractable","Eye.Pain","Illusions","Nevus..Pigmented","Spondylosis","Lichen.Planus","Hyperkalemia","Urinary.Fistula","Barotrauma","Cholecystitis..Acute","Vasculitis..Central.Nervous.System","Hyperuricemia","Dyslexia","Hemochromatosis","Retinal.Hemorrhage","Cardiac.Tamponade","Frontotemporal.Dementia","Plasmacytoma","Rhabdomyolysis","Cerebrovascular.Trauma","Edema..Cardiac","Carcinoma..Intraductal..Noninfiltrating","Hepatitis..Alcoholic","Smallpox","Leptospirosis","Myalgia","Philadelphia.Chromosome","Epilepsy..Absence","Pneumoperitoneum","Shoulder.Fractures","Tuberous.Sclerosis","Diabetic.Ketoacidosis","Tachycardia..Sinus","Cryptorchidism","Foot.Deformities..Congenital","Pancreatic.Cyst","Protein.Energy.Malnutrition","Pregnancy..Tubal","Hyperaldosteronism","Heroin.Dependence","Urinary.Bladder..Neurogenic","Exanthema","Oral.Ulcer","Toxemia","Lower.Extremity.Deformities..Congenital","Intermittent.Claudication","Radiculopathy","Anemia..Macrocytic","Esophageal.Fistula","Atrial.Flutter","Fasciitis","Foreign.Body.Migration","Kimura.Disease","Malaria..Vivax","Choroidal.Neovascularization","Malocclusion..Angle.Class.II","Bacteriuria","Jaw.Fractures","Fatigue.Syndrome..Chronic","Sarcoidosis..Pulmonary","Medulloblastoma","Tonsillitis","Behcet.Syndrome","Purpura..Thrombocytopenic..Idiopathic","Endotoxemia","Sciatic.Neuropathy","Muscular.Atrophy..Spinal","Hypoparathyroidism","Tuberculosis..Osteoarticular","Marijuana.Abuse","Coronary.Vessel.Anomalies","Acute.Phase.Reaction","Asthma..Occupational","Chondrosarcoma","Serotonin.Syndrome","Fetal.Hypoxia","Parasitemia","Carcinoma..Medullary","Thyrotoxicosis","Foot.Deformities..Acquired","Reinfection","Whooping.Cough","Amblyopia","Border.Disease","Jaundice..Obstructive","Shock..Traumatic","Quadriplegia","Myxoma","Plaque..Amyloid","Pneumonia..Pneumococcal","Influenza.in.Birds","Melanosis","Torsion.Abnormality","Adenomatous.Polyposis.Coli","Trigeminal.Neuralgia","Respiratory.Aspiration","Nasal.Polyps","Helminthiasis..Animal","Choriocarcinoma","Ureteral.Calculi","Hypertension..Renovascular","Orthostatic.Intolerance","Mastitis..Bovine","Bronchopulmonary.Dysplasia","Developmental.Dysplasia.of.the.Hip","Femur.Head.Necrosis","Sarcoma..Ewing","Carcinoma..Lobular","Fetal.Membranes..Premature.Rupture","Burns..Chemical","Neuroma..Acoustic","Hyperostosis","Hypotension..Orthostatic","Cyanosis","Vesicular.Stomatitis","Diverticulitis","Acidosis..Lactic","Porphyrias","Tooth.Resorption","Swayback","Listeriosis","Pulmonary.Atelectasis","Shoulder.Dislocation","Peptic.Ulcer.Hemorrhage","Hand.Deformities","Retinopathy.of.Prematurity","Angioedema","Lordosis","Granulomatosis.with.Polyangiitis","Fractures..Spontaneous","Spinal.Dysraphism","Blister","Glomerulonephritis..IGA","Folic.Acid.Deficiency","Tuberculosis..Central.Nervous.System","Mandibular.Fractures","Pancytopenia","Febrile.Neutropenia","Pulmonary.Aspergillosis","Vitreous.Detachment","Jaw..Edentulous","Candidiasis..Oral","Enterocolitis..Necrotizing","Hyperbilirubinemia..Neonatal","Pulmonary.Valve.Insufficiency","Chickenpox","Cystadenocarcinoma","Wounds..Stab","Epistaxis","Bronchial.Hyperreactivity","Hyperhomocysteinemia","Jaundice..Neonatal","Parasomnias","Hemolytic.Uremic.Syndrome","Abortion..Habitual","Prediabetic.State","Erythema.Multiforme","Hemangioma..Cavernous","Nystagmus..Pathologic","Plant.Poisoning","Parkinson.Disease..Secondary","Hip.Dislocation..Congenital","Hyperoxia","Severe.Combined.Immunodeficiency","Silicosis","Hearing.Loss..Noise.Induced","Adenocarcinoma.in.Situ","Respiratory.Tract.Fistula","Vitiligo","Barrett.Esophagus","Tooth.Fractures","Uterine.Rupture","Thrombocytosis","Spinocerebellar.Degenerations","Latent.Tuberculosis","Cardiac.Complexes..Premature","Jaw.Cysts","Hernia..Hiatal","Liver.Cirrhosis..Experimental","Drug.Resistant.Epilepsy","Tricuspid.Valve.Insufficiency","Infectious.Mononucleosis","Angiomatosis","Agammaglobulinemia","Tooth..Impacted","Abortion..Veterinary","Dyskinesia..Drug.Induced","Hearing.Loss..Bilateral","Choristoma","Adrenal.Hyperplasia..Congenital","Vesico.Ureteral.Reflux","Giant.Cell.Arteritis","Polycythemia.Vera","Megacolon","Esophageal.Achalasia","Lacerations","Keratoconus","Histiocytoma","Heavy.Chain.Disease","Anastomotic.Leak","Epilepsy..Tonic.Clonic","Williams.Syndrome","Stenosis..Pulmonary.Artery","Visceral.Pain","Transposition.of.Great.Vessels","Urinary.Bladder..Overactive","Aging..Premature","Carcinoma..Adenoid.Cystic","Ventilator.Induced.Lung.Injury","Rectal.Fistula","Gestational.Weight.Gain","Tooth.Wear","Adenoma..Islet.Cell","Reflex..Abnormal","Zika.Virus.Infection","Snoring","Meningitis..Viral","Anemia..Megaloblastic","Subcutaneous.Emphysema","Granulomatous.Disease..Chronic","Convalescence","Endolymphatic.Hydrops","Acidosis..Respiratory","Pneumonia..Ventilator.Associated","Hereditary.Sensory.and.Motor.Neuropathy","Alkalosis","alpha.Thalassemia","Gastric.Outlet.Obstruction","Marfan.Syndrome","Rhinitis..Allergic..Perennial","Yellow.Fever","Dysentery..Bacillary","Lymphoma..T.Cell..Peripheral","Tracheal.Stenosis","Hand.Dermatoses","Cholesteatoma","Contusions","Lung.Abscess","Taeniasis","Glomerulosclerosis..Focal.Segmental","Pleural.Effusion..Malignant","Liposarcoma","Anemia..Hemolytic..Autoimmune","Dysmenorrhea","Carotid.Artery.Thrombosis","Actinomycosis","Lupus.Erythematosus..Cutaneous","Leukemia..Plasma.Cell","Embolism..Air","Mycosis.Fungoides","Uveitis..Posterior","Multiple.Endocrine.Neoplasia","Primary.Myelofibrosis","Pneumonia..Mycoplasma","Prostatitis","Anthrax","Asphyxia.Neonatorum","Odontogenic.Cysts","Cystadenoma","Leukemia.L1210","Mastocytosis","Spinocerebellar.Ataxias","Hyperlipoproteinemia.Type.II","Cholangitis..Sclerosing","Hypertrophy..Right.Ventricular","Mesenteric.Ischemia","Facial.Dermatoses","Osteochondritis","Pleurisy","Hemangiosarcoma","Vocal.Cord.Paralysis","Mite.Infestations","Dysarthria","Cerebrospinal.Fluid.Leak","Hypoalbuminemia","Hypospadias","Meniere.Disease","Tuberculosis..Lymph.Node","Anemia..Neonatal","Glycogen.Storage.Disease","Insulinoma","Conjunctivitis..Bacterial","Lethargy","Duodenal.Obstruction","Leukemia.Lymphoma..Adult.T.Cell","Multiple.System.Atrophy","Healthcare.Associated.Pneumonia","Tuberculosis..Urogenital","Pseudarthrosis","Azoospermia","Binge.Drinking","Pancreatic.Fistula","Labor.Pain","Raynaud.Disease","Histoplasmosis","Diarrhea..Infantile","Tachycardia..Paroxysmal","Tuberculosis..Meningeal","Urethral.Stricture","Mitral.Valve.Prolapse","Esophageal.Perforation","Talipes","Adenocarcinoma..Clear.Cell","Paraparesis","Encephalitis..Japanese","Asthenia","Potassium.Deficiency","Psychoses..Substance.Induced","Enterocolitis..Pseudomembranous","Morphological.and.Microscopic.Findings","Meningitis..Meningococcal","Lithiasis","Spondylolisthesis","Cysticercosis","Frontotemporal.Lobar.Degeneration","Acute.On.Chronic.Liver.Failure","Carcinosarcoma","Psychomotor.Agitation","Hyperprolactinemia","Magnesium.Deficiency","Papilledema","Heart.Valve.Prolapse","Ureterolithiasis","Parotitis","Stevens.Johnson.Syndrome","Hoarseness","Otitis.Media.with.Effusion","Myotonic.Dystrophy","Failure.to.Thrive","Osteoma","Osteomalacia","Trypanosomiasis..African","Periodontal.Attachment.Loss","Lewy.Body.Disease","Mucopolysaccharidoses","Iliac.Aneurysm","Fragile.X.Syndrome","Hypergammaglobulinemia","Retinal.Vein.Occlusion","Uterine.Prolapse","Lymphangioma","Mucocutaneous.Lymph.Node.Syndrome","Carcinoma..Papillary..Follicular","Hepatitis..Viral..Animal","Ependymoma","Tuberculosis..Pleural","Leukoplakia","Vitamin.A.Deficiency","Sciatica","Polyarteritis.Nodosa","Fever.of.Unknown.Origin","Phenylketonurias","Craniosynostoses","Hypophosphatemia","Facial.Asymmetry","Multiple.Chemical.Sensitivity","Lymphoma..B.Cell..Marginal.Zone","Pyoderma","Parental.Death","Hemorrhoids","Endometrial.Hyperplasia","Malocclusion..Angle.Class.I","Gestational.Trophoblastic.Disease","Lipodystrophy","Cryptosporidiosis","Empyema..Pleural","Hemorrhagic.Fever..Ebola","Dystocia","Root.Resorption","Mobility.Limitation","Ichthyosis","Chromosome.Inversion","Toxoplasmosis..Animal","Amputation..Traumatic","Creutzfeldt.Jakob.Syndrome","Gastric.Fistula","Congenital.Hypothyroidism","Hypertension..Malignant","Hirsutism","Peptic.Ulcer.Perforation","Purpura..Thrombotic.Thrombocytopenic","Echinococcosis..Hepatic","AIDS.Related.Complex","Vascular.Ring","Milk.Hypersensitivity","Corneal.Ulcer","Carcinoma..Embryonal","Migraine.with.Aura","Migraine.without.Aura","Embolic.Stroke","Epidermolysis.Bullosa","Ectodermal.Dysplasia","Adenoma..Pleomorphic","Keratoconjunctivitis","Puberty..Precocious","Insect.Bites.and.Stings","Carbon.Monoxide.Poisoning","Blepharoptosis","Anemia..Refractory","Myelitis..Transverse","Vaginal.Discharge","Bursitis","Carcinoma..Endometrioid","Lymphoma..Mantle.Cell","Hypoventilation","Ventricular.Premature.Complexes","Foramen.Ovale..Patent","Malignant.Hyperthermia","Biliary.Fistula","Xeroderma.Pigmentosum","Lymphocytosis","Enuresis","Foot.Dermatoses","Seminoma","Hypovolemia","Endometritis","Urethritis","Spinal.Cord.Ischemia","Giardiasis","Drowning","Hearing.Loss..Conductive","Oligospermia","Hemoglobinuria","Osteosclerosis","Pemphigoid..Bullous","Bronchopneumonia","Anemia..Pernicious","Hepatitis.E","Chronic.Urticaria","Thiamine.Deficiency","Atrial.Remodeling","Rhinorrhea","Wolff.Parkinson.White.Syndrome","Leukemia..Myeloid..Chronic.Phase","Myoma","Tuberculosis..Spinal","Gilbert.Disease","Spondylolysis","Pulmonary.Eosinophilia","Histiocytoma..Benign.Fibrous","Dysphonia","Protein.Aggregation..Pathological","Mucormycosis","Vaginal.Fistula","Kidney.Tubular.Necrosis..Acute","Glomerulonephritis..Membranous","Osteogenesis.Imperfecta","Menorrhagia","Morphine.Dependence","Narcolepsy","Glycosuria","Adenocarcinoma..Follicular","Craniofacial.Dysostosis","Vitreous.Hemorrhage","Gingival.Pocket","Heartburn","Polyuria","Hepatolenticular.Degeneration","Virilism","Ascariasis","Respiratory.Paralysis","Splenic.Rupture","Urinary.Bladder.Fistula","Gaucher.Disease","Precursor.B.Cell.Lymphoblastic.Leukemia.Lymphoma","Corneal.Edema","Periapical.Periodontitis","Neointima","Sarcoma..Avian","Dermoid.Cyst","IgG.Deficiency","Fibrous.Dysplasia.of.Bone","Hypereosinophilic.Syndrome","Encephalitis..Tick.Borne","Esophagitis..Peptic","Corneal.Opacity","Q.Fever","Mercury.Poisoning","Legionellosis","Tuberculosis..Renal","Ascorbic.Acid.Deficiency","Waldenstrom.Macroglobulinemia","Leukemia..Radiation.Induced","Mitochondrial.Myopathies","Sarcoma..Small.Cell","Superinfection","Airway.Remodeling","Otosclerosis","Dysgerminoma","Sleep.Apnea..Central","Varicose.Ulcer","Meningitis..Pneumococcal","Tuberculosis..Cutaneous","Ulna.Fractures","Scalp.Dermatoses","Lameness..Animal","Hemothorax","Craniopharyngioma","Wasting.Syndrome","Situs.Inversus","Vulvitis","Fanconi.Anemia","Varicocele","Neuromyelitis.Optica","Oral.Fistula","Drug.Hypersensitivity.Syndrome","Seroma","Chromosome.Breakage","Squamous.Intraepithelial.Lesions","Fractures..Comminuted","Polycystic.Kidney..Autosomal.Dominant","Purpura..Schoenlein.Henoch","Vasospasm..Intracranial","Delayed.Graft.Function","Cone.Dystrophy","Short.Bowel.Syndrome","Leukemia..Erythroblastic..Acute","Hydatidiform.Mole","Snake.Bites","Glucosephosphate.Dehydrogenase.Deficiency","Muscular.Dystrophy..Animal","Precursor.T.Cell.Lymphoblastic.Leukemia.Lymphoma","Albinism","Glaucoma..Angle.Closure","Pulmonary.Atresia","Epilepsies..Myoclonic","Chorioamnionitis","Pain..Procedural","Tourette.Syndrome","Biliary.Atresia","Lymphoma..Large.Cell..Anaplastic","Gastritis..Atrophic","Coronary.Vasospasm","Fungemia","Maxillary.Sinusitis","Syndactyly","Condylomata.Acuminata","Candidiasis..Invasive","Cystadenocarcinoma..Serous","Retinal.Perforations","Brugada.Syndrome","Leukoplakia..Oral","West.Nile.Fever","Xanthomatosis","Anuria","Hearing.Loss..Central","Hernia..Umbilical","Conjunctivitis..Allergic","Rib.Fractures","Tuberculosis..Bovine","Vertebrobasilar.Insufficiency","Dermatitis..Irritant","Hernias..Diaphragmatic..Congenital","Takotsubo.Cardiomyopathy","Phagocyte.Bactericidal.Dysfunction","Goiter..Nodular","Seizures..Febrile","Hemophilia.B","Charcot.Marie.Tooth.Disease","Legionnaires..Disease","Heavy.Metal.Poisoning..Nervous.System","Bacterial.Zoonoses","Dyspareunia","Bites..Human","Solitary.Pulmonary.Nodule","Sinus.Thrombosis..Intracranial","Esophageal.Atresia","Cerebral.Intraventricular.Hemorrhage","Addison.Disease","Bronchiolitis.Obliterans","Abnormal.Karyotype","Amyloidosis..Familial","Keloid","Tick.Infestations","Hirschsprung.Disease","Alopecia.Areata","Restless.Legs.Syndrome","Incisional.Hernia","Vulvovaginitis","Spontaneous.Perforation","Dental.Leakage","Scrapie","Babesiosis","Solitary.Kidney","Intestinal.Volvulus","Tics","Orbital.Fractures","Granular.Cell.Tumor","Fasciitis..Necrotizing","Muscle.Hypotonia","Coloboma","Eye.Foreign.Bodies","Lymphohistiocytosis..Hemophagocytic","Paratyphoid.Fever","Mesenteric.Vascular.Occlusion","Pancreatic.Pseudocyst","Placenta.Previa","Sarcoma..Synovial","Zygomycosis","Cytokine.Release.Syndrome","Flank.Pain","Hyperandrogenism","Essential.Tremor","Anhedonia","Leukemia..Hairy.Cell","Hearing.Loss..High.Frequency","Choledocholithiasis","Bronchial.Fistula","Viral.Zoonoses","Cholesteatoma..Middle.Ear","Hearing.Loss..Unilateral","Mediastinitis","Brain.Hemorrhage..Traumatic","Vaginosis..Bacterial","Hematemesis","Gingival.Recession","Hemoperitoneum","Syringomyelia","Hyperopia","Gynecomastia","Fabry.Disease","Lichen.Planus..Oral","Pyloric.Stenosis","Endoleak","Chills","Oligodendroglioma","Epidermal.Cyst","Osteitis.Deformans","Central.Nervous.System.Cysts","Simian.Acquired.Immunodeficiency.Syndrome","Melena","Trichinellosis","Trachoma","Hyperhidrosis","Takayasu.Arteritis","Supranuclear.Palsy..Progressive","Spasms..Infantile","Torticollis","Ototoxicity","Knee.Dislocation","Scleroderma..Localized","Tuberculosis..Gastrointestinal","Onchocerciasis","Tracheoesophageal.Fistula","Urinary.Bladder.Neck.Obstruction","Scabies","Carcinoma..Lewis.Lung","Exostoses","alpha.1.Antitrypsin.Deficiency","Thrombocythemia..Essential","Dysuria","Panniculitis","Corneal.Dystrophies..Hereditary","Hearing.Loss..Functional","Anterior.Wall.Myocardial.Infarction","Altitude.Sickness","Stuttering","Thrombotic.Stroke","Temporomandibular.Joint.Dysfunction.Syndrome","Agenesis.of.Corpus.Callosum","Diverticulosis..Colonic","Hand.Deformities..Congenital","Graves.Ophthalmopathy","Moyamoya.Disease","Giant.Cell.Tumor.of.Bone","Asbestosis","Paraganglioma..Extra.Adrenal","Laryngitis","Premenstrual.Syndrome","Carbon.Tetrachloride.Poisoning","Chordoma","Eye.Burns","Familial.Mediterranean.Fever","Embolism..Fat","Ameloblastoma","Herpes.Genitalis","Intra.Articular.Fractures","Hypoproteinemia","Diverticulitis..Colonic","Hemangioendothelioma","Food.Intolerance","Mucocele","Lentigo","Pancreatitis..Acute.Necrotizing","Hearing.Loss..Sudden","Histiocytoma..Malignant.Fibrous","Tenosynovitis","Sialadenitis","Autolysis","Hyperammonemia","Cryoglobulinemia","Mixed.Tumor..Malignant","Encephalocele","Epilepsy..Complex.Partial","Ileitis","Meningomyelocele","Severe.Dengue","Decerebrate.State","Hot.Flashes","Leukemia..Monocytic..Acute","Hyperkinesis","Encephalitis..Herpes.Simplex","Blast.Crisis","IgA.Deficiency","Erythema.Nodosum","Retinal.Artery.Occlusion","Trichostrongyloidiasis","Neurogenic.Inflammation","Severe.Acute.Malnutrition","Heart.Murmurs","Superior.Vena.Cava.Syndrome","Disorder.of.Sex.Development..46.XY","Rectal.Prolapse","Epilepsy..Frontal.Lobe","Rosacea","Keratitis..Herpetic","Cholestasis..Extrahepatic","Klinefelter.Syndrome","Aneurysm..Infected","Proctitis","Tuberculosis..Oral","Puberty..Delayed","Clubfoot","Ehlers.Danlos.Syndrome","Hallux.Valgus","Urinary.Bladder.Calculi","Fractures..Cartilage","Hand.Foot.Syndrome","Alveolitis..Extrinsic.Allergic","Breech.Presentation","Onychomycosis","Tuberculosis..Miliary","Scotoma","Hemangioma..Capillary","Pseudotumor.Cerebri","Tardive.Dyskinesia","Tricuspid.Valve.Stenosis","Mediastinal.Emphysema","Epiretinal.Membrane","Neurosyphilis","Leukoencephalopathy..Progressive.Multifocal","Cluster.Headache","Arteriosclerosis.Obliterans","Pneumonia..Staphylococcal","Choroiditis","Multiple.Sclerosis..Chronic.Progressive","Upper.Extremity.Deformities..Congenital","Multiple.Pulmonary.Nodules","Color.Vision.Defects","Myxedema","Leprosy..Lepromatous","Cutaneous.Fistula","Meningitis..Haemophilus","Keratosis..Actinic","Jaw..Edentulous..Partially","Hypercalciuria","Hidradenitis","Malocclusion..Angle.Class.III","Fascioliasis","Chylothorax","von.Hippel.Lindau.Disease","Fetal.Macrosomia","Strongyloidiasis","Carcinoma..Signet.Ring.Cell","Glomus.Tumor","Hyperphosphatemia","Adrenocortical.Carcinoma","Anovulation","Neoplasm.Seeding","Tularemia","Hemoglobinuria..Paroxysmal","Bronchial.Spasm","Urinary.Incontinence..Urge","Hydrocephalus..Normal.Pressure","Chronic.Kidney.Disease.Mineral.and.Bone.Disorder","Acidosis..Renal.Tubular","Meningitis..Aseptic","Sunburn","Esotropia","Chondroma","Hypoplastic.Left.Heart.Syndrome","Paratuberculosis","Brachial.Plexus.Neuropathies","Muscle.Rigidity","Pericarditis..Constrictive","Lymphocytic.Choriomeningitis","Elephantiasis","Anosmia","Bruxism","Prader.Willi.Syndrome","Dysentery..Amebic","Botulism","Dental.Calculus","Cystitis..Interstitial","Carcinoma..Merkel.Cell","Hypernatremia","Candidiasis..Vulvovaginal","Chikungunya.Fever","Glomerulonephritis..Membranoproliferative","Lupus.Erythematosus..Discoid","Tension.Type.Headache","Budd.Chiari.Syndrome","Rett.Syndrome","AIDS.Dementia.Complex","Methemoglobinemia","Sneezing","Meningitis..Fungal","Arnold.Chiari.Malformation","Maxillary.Fractures","Angiomyolipoma","Stomatitis..Aphthous","Spinal.Osteophytosis","Tooth.Mobility","Reflex.Sympathetic.Dystrophy","Hepatoblastoma","Hypesthesia","Common.Variable.Immunodeficiency","Osteochondroma","Decompression.Sickness","Pseudorabies","Tooth.Discoloration","Telangiectasia..Hereditary.Hemorrhagic","Leukemia..Myelomonocytic..Acute","Tachycardia..Reciprocating","Porcine.Reproductive.and.Respiratory.Syndrome","Pica","Hidradenitis.Suppurativa","Toxoplasmosis..Congenital","Self.Mutilation","Anemia..Hypoplastic..Congenital","Puerperal.Infection","Paraparesis..Spastic","Aphakia","Myiasis","Intracranial.Hypotension","Mouth.Breathing","Malaria..Cerebral","Hematoma..Subdural..Chronic","Syphilis..Congenital","Ovarian.Hyperstimulation.Syndrome","Nocturia","Photophobia","Exocrine.Pancreatic.Insufficiency","Asthma..Exercise.Induced","Anencephaly","Torsades.de.Pointes","Trichomonas.Vaginitis","Oliguria","Anodontia","Burns..Inhalation","Prolactinoma","Eosinophilic.Granuloma","Sick.Sinus.Syndrome","Heat.Stroke","Pyoderma.Gangrenosum","Polyhydramnios","Salmonella.Food.Poisoning","Prognathism","Meckel.Diverticulum","Vitamin.E.Deficiency","Hemangiopericytoma","Hypokinesia","Tachypnea","Porphyrias..Hepatic","Leydig.Cell.Tumor","Dentin.Sensitivity","Arsenic.Poisoning","Primary.Ovarian.Insufficiency","Pterygium","Root.Caries","Motion.Sickness","Agnosia","Wet.Macular.Degeneration","Carcinoma..Adenosquamous","Carcinoma..Mucoepidermoid","Lymphoma..AIDS.Related","Extravasation.of.Diagnostic.and.Therapeutic.Materials","Mycobacterium.avium.intracellulare.Infection","Avian.Leukosis","Gait.Ataxia","Meningitis..Cryptococcal","Polydactyly","Granulosa.Cell.Tumor","Pulpitis","Fractures..Avulsion","Gastroparesis","Miosis","Radiation.Pneumonitis","Tuberculoma","Lipomatosis","Cerebral.Amyloid.Angiopathy","Pityriasis","Invasive.Pulmonary.Aspergillosis","X22q11.Deletion.Syndrome","Hemianopsia","Bone.Malalignment","Sickle.Cell.Trait","Leukemia.P388","Encephalopathy..Bovine.Spongiform","Injection.Site.Reaction","Lactose.Intolerance","Toothache","Intestinal.Pseudo.Obstruction","Granuloma..Foreign.Body","Fibroadenoma","Specific.Language.Disorder","Chemical.and.Drug.Induced.Liver.Injury..Chronic","Peri.Implantitis","Diverticulum..Colon","Catatonia","Bicuspid.Aortic.Valve.Disease","Organophosphate.Poisoning","Eosinophilic.Esophagitis","Intestinal.Atresia","Placenta.Accreta","Persistent.Vegetative.State","Catalepsy","Hydrops.Fetalis","Fanconi.Syndrome","Tooth.Erosion","Sertoli.Leydig.Cell.Tumor","Open.Bite","Arachnoid.Cysts","Pallor","Hematoma..Subdural..Intracranial","Coccidioidomycosis","Neoplasm.Regression..Spontaneous","Corneal.Neovascularization","Hematoma..Epidural..Cranial","Water.Intoxication","Thyroid.Carcinoma..Anaplastic","Middle.Lobe.Syndrome","Nephrocalcinosis","Wiskott.Aldrich.Syndrome","Diabetic.Coma","Carcinoma..Islet.Cell","Myotonia","Sarcoma.180","Cerebrospinal.Fluid.Rhinorrhea","Castleman.Disease","Tooth.Abrasion","Polydipsia","Folliculitis","Bronchiolitis..Viral","Carotid.Artery..Internal..Dissection","Dextrocardia","Polymyalgia.Rheumatica","Retroperitoneal.Fibrosis","Zollinger.Ellison.Syndrome","Fibrocystic.Breast.Disease","Osteopetrosis","Hemosiderosis","Ring.Chromosomes","Diverticulosis..Esophageal","Granuloma..Giant.Cell","Epididymitis","Candidemia","Neurocysticercosis","Cicatrix..Hypertrophic","Placental.Insufficiency","Tachycardia..Atrioventricular.Nodal.Reentry","Otitis.Media..Suppurative","Adenomyosis","Ehrlichiosis","Dermatitis..Seborrheic","Encephalomyelitis..Acute.Disseminated","Bluetongue","Mediastinal.Cyst","Vitreoretinopathy..Proliferative","Liver.Abscess..Amebic","Hemorrhagic.Fever.with.Renal.Syndrome","Osteoma..Osteoid","Stroke..Lacunar","Hyaline.Membrane.Disease","Feminization","Meningocele","Dental.Pulp.Necrosis","Burns..Electric","White.Muscle.Disease","Diverticulum..Esophageal","Macrophage.Activation.Syndrome","Cerebral.Hemorrhage..Traumatic","Apraxias","Dysgammaglobulinemia","Trismus","Fluorosis..Dental","Leg.Length.Inequality","Gingival.Overgrowth","Nelson.Syndrome","Sarcoma..Myeloid","Diabetic.Cardiomyopathies","Primary.Graft.Dysfunction","Rheumatoid.Vasculitis","Chorioretinitis","Tuberculosis..Cardiovascular","Lice.Infestations","Melioidosis","Goiter..Endemic","Encephalomalacia","Trigeminal.Autonomic.Cephalalgias","Tetany","Noma","Choline.Deficiency","Granuloma..Plasma.Cell","Leprosy..Multibacillary","Thromboangiitis.Obliterans","Epidural.Abscess","Otitis.Externa","Lacrimal.Duct.Obstruction","Hypersplenism","Wallerian.Degeneration","Dermatitis.Herpetiformis","Orchitis","Anomalous.Left.Coronary.Artery","Autoimmune.Pancreatitis","Aggressive.Periodontitis","Myocardial.Stunning","Echinococcosis..Pulmonary","DiGeorge.Syndrome","Gastric.Dilatation","Ventricular.Flutter","Hand..Foot.and.Mouth.Disease","Ecchymosis","Aortitis","Osteochondrosis","Wasting.Disease..Chronic","Adrenocortical.Adenoma","Micronuclei..Chromosome.Defective","Pseudophakia","Periprosthetic.Fractures","Vertebral.Artery.Dissection","Metrorrhagia","Keratoderma..Palmoplantar","Joint.Deformities..Acquired","Exotropia","Synovial.Cyst","Ganglioneuroma","Werner.Syndrome","Oligohydramnios","Egg.Hypersensitivity","Nose.Deformities..Acquired","Priapism","Hyperoxaluria","Anus..Imperforate","Monoclonal.Gammopathy.of.Undetermined.Significance","Hepatitis.D","Anti.Glomerular.Basement.Membrane.Disease","Blastomycosis","Churg.Strauss.Syndrome","Dermatitis..Exfoliative","Hemarthrosis","Gingival.Hemorrhage","Hematoma..Subdural..Acute","Optic.Neuropathy..Ischemic","Arrhythmogenic.Right.Ventricular.Dysplasia","Carcinoma..Giant.Cell","HELLP.Syndrome","Nocturnal.Enuresis","Breast.Cancer.Lymphedema","Syncope..Vasovagal","Choledochal.Cyst","Friedreich.Ataxia","Pancreatitis..Alcoholic","Hypertelorism","Immunoglobulin.Light.chain.Amyloidosis","Bile.Reflux","Arthrogryposis","Tympanic.Membrane.Perforation","Rhabdoid.Tumor","Laryngostenosis","Flatfoot","Spermatic.Cord.Torsion","Brain.Contusion","Peanut.Hypersensitivity","Flatulence","Leukemia..Myelomonocytic..Chronic","Osteophyte","Rhabdomyosarcoma..Embryonal","Hypertensive.Encephalopathy","Thoracic.Outlet.Syndrome","Classical.Swine.Fever","Scleroderma..Limited","Mutism","Scarlet.Fever","Achondroplasia","Distemper","Lymphangioma..Cystic","Hand.Deformities..Acquired","Cocarcinogenesis","Marek.Disease","Mixed.Connective.Tissue.Disease","Non.ST.Elevated.Myocardial.Infarction","Kwashiorkor","Tooth..Supernumerary","Mydriasis","Renal.Colic","Mycotoxicosis","Chagas.Cardiomyopathy","Dwarfism..Pituitary","Mastoiditis","Inappropriate.ADH.Syndrome","Cytomegalovirus.Retinitis","Leigh.Disease","Abortion..Threatened","Toxocariasis","Whipple.Disease","Psittacosis","Hepatorenal.Syndrome","Abruptio.Placentae","Discitis","Brenner.Tumor","Acute.Radiation.Syndrome","Yin.Deficiency","Elephantiasis..Filarial","Latex.Hypersensitivity","Decapitation","Vesicovaginal.Fistula","Adenoma..Liver.Cell","Osteoarthritis..Spine","Endomyocardial.Fibrosis","Fibromuscular.Dysplasia","Gas.Gangrene","Red.Cell.Aplasia..Pure","Dupuytren.Contracture","Rickets..Hypophosphatemic","Bladder.Exstrophy","Spherocytosis..Hereditary","Leukomalacia..Periventricular","Leukemic.Infiltration","Hyphema","Azotemia","Anaplasmosis","Amyloid.Neuropathies","Phantom.Limb","Polyradiculopathy","Mitochondrial.Encephalomyopathies","Scurvy","Cystadenoma..Mucinous","Monkeypox","Pregnancy..Interstitial","Overbite","Tooth.Avulsion","Funnel.Chest","Adenoma..Sweat.Gland","Neuroleptic.Malignant.Syndrome","Retinal.Drusen","Carcinoma.256..Walker","Job.Syndrome","Sezary.Syndrome","Endocarditis..Subacute.Bacterial","Adenoma..Bile.Duct","Nephrosis..Lipoid","Erysipelas","Endocarditis..Non.Infective","Weil.Disease","REM.Sleep.Behavior.Disorder","Arthritis..Gouty","Tick.Bites","Scrub.Typhus","Dirofilariasis","Central.Cord.Syndrome","Neuralgia..Postherpetic","Uterine.Cervicitis","Galactorrhea","Multiple.Endocrine.Neoplasia.Type.1","Osteoradionecrosis","African.Swine.Fever","Central.Serous.Chorioretinopathy","Acrodermatitis","Salpingitis","Hypocapnia","Subacute.Sclerosing.Panencephalitis","Optic.Atrophies..Hereditary","Hematoma..Epidural..Spinal","Tinea.Capitis","Frostbite","Corneal.Endothelial.Cell.Loss","Mycetoma","Aspergillosis..Allergic.Bronchopulmonary","Focal.Nodular.Hyperplasia","Tuberculosis..Female.Genital","Gastroschisis","Radiodermatitis","Familial.Primary.Pulmonary.Hypertension","Ulnar.Neuropathies","Bowen.s.Disease","Osteochondritis.Dissecans","Fetal.Resorption","Schistosomiasis.japonica","Sertoli.Cell.Tumor","Vasculitis..Leukocytoclastic..Cutaneous","Bezoars","Extensively.Drug.Resistant.Tuberculosis","Dental.Enamel.Hypoplasia","Mastocytosis..Systemic","Noonan.Syndrome","Retinal.Vasculitis","Hypertrichosis","Aortic.Stenosis..Supravalvular","Hyperbilirubinemia..Hereditary","Keratitis..Dendritic","Gangliosidoses","Smear.Layer","Horner.Syndrome","Vascular.Headaches","Peritoneal.Fibrosis","CREST.Syndrome","Adenocarcinoma..Bronchiolo.Alveolar","Serum.Sickness","Spotted.Fever.Group.Rickettsiosis","Carcinoma..Acinar.Cell","Laryngeal.Edema","Vitamin.K.Deficiency","Subarachnoid.Hemorrhage..Traumatic","Androgen.Insensitivity.Syndrome","Prostatic.Intraepithelial.Neoplasia","Encephalomyelitis..Equine","Benign.Paroxysmal.Positional.Vertigo","Phyllodes.Tumor","Cystadenocarcinoma..Mucinous","Channelopathies","Peutz.Jeghers.Syndrome","Shoulder.Impingement.Syndrome","Muscle.Cramp","Cat.Scratch.Disease","Toxoplasmosis..Ocular","Acanthosis.Nigricans","Hemangioblastoma","Teratocarcinoma","Focal.Infection..Dental","Afibrinogenemia","Steatorrhea","Myositis.Ossificans","Cadmium.Poisoning","Adrenoleukodystrophy","Patellar.Dislocation","Chondrocalcinosis","Sweet.Syndrome","Mandibulofacial.Dysostosis","Brucellosis..Bovine","Intra.Abdominal.Hypertension","Nephrosclerosis","Duodenitis","Microphthalmos","Amyloid.Neuropathies..Familial","Catastrophic.Illness","Schistosomiasis.haematobia","Pyuria","Adenoma..Villous","Spastic.Paraplegia..Hereditary","Tooth..Unerupted","Exfoliation.Syndrome","Presbyopia","Uniparental.Disomy","Night.Blindness","Alkalosis..Respiratory","Gingival.Hyperplasia","Sacroiliitis","Femoracetabular.Impingement","Carotid.Body.Tumor","Tooth..Nonvital","Relapsing.Fever","Polyradiculoneuropathy..Chronic.Inflammatory.Demyelinating","Central.Nervous.System.Helminthiasis","Dumping.Syndrome","Elbow.Tendinopathy","Trichuriasis","Substance.Abuse..Oral","Colitis..Microscopic","Squamous.Intraepithelial.Lesions.of.the.Cervix","Tennis.Elbow","Hernia..Femoral","Malignant.Carcinoid.Syndrome","Insulin.Coma","Nondisjunction..Genetic","Travel.Related.Illness","Siderosis","Hemifacial.Spasm","Paraparesis..Tropical.Spastic","Masked.Hypertension","Embolism..Paradoxical","Cardiomyopathy..Restrictive","Frontal.Sinusitis","Fibromatosis..Aggressive","Ectropion","Epiphyses..Slipped","Ectromelia","Colitis..Ischemic","Retrognathia","Paracoccidioidomycosis","Infarction..Anterior.Cerebral.Artery","Carotid.Cavernous.Sinus.Fistula","Keratoacanthoma","Teratogenesis","Dental.Pulp.Exposure","Menopause..Premature","Dentin..Secondary","Pleuropneumonia","Uterine.Perforation","Sporotrichosis","Scleritis","Heart.Rupture..Post.Infarction","Spina.Bifida.Occulta","Velopharyngeal.Insufficiency","Inferior.Wall.Myocardial.Infarction","Homocystinuria","Testicular.Hydrocele","Dermatofibrosarcoma","Leg.Dermatoses","Adenoma..Oxyphilic","Dacryocystitis","Progeria","Leukemia..Feline","Muscular.Dystrophies..Limb.Girdle","Anemia..Sideroblastic","Nephritis..Hereditary","Stomach.Rupture","Pilonidal.Sinus","Renal.Aminoacidurias","Lupus.Vulgaris","Toxoplasmosis..Cerebral","Typhus..Epidemic.Louse.Borne","Zygomatic.Fractures","Psychoses..Alcoholic","Adenofibroma","Penile.Induration","Theileriasis","Hydrothorax","Diffuse.Cerebral.Sclerosis.of.Schilder","Blepharospasm","Retrograde.Degeneration","Sarcoma..Yoshida","Cauda.Equina.Syndrome","Mastocytosis..Cutaneous","Chemotherapy.Induced.Febrile.Neutropenia","Tooth.Migration","Placenta..Retained","Angina.Pectoris..Variant","Neuronal.Ceroid.Lipofuscinoses","Tuberculosis..Hepatic","Microscopic.Polyangiitis","Rift.Valley.Fever","Granuloma..Pyogenic","Protein.Losing.Enteropathies","Infarction..Posterior.Cerebral.Artery","Porphyria..Acute.Intermittent","Dentigerous.Cyst","Fetofetal.Transfusion","Fissure.in.Ano","Pulmonary.Alveolar.Proteinosis","Hypophosphatemia..Familial","Sarcoma..Clear.Cell","Exsanguination","Galactosemias","Tuberculosis..Ocular","Double.Outlet.Right.Ventricle","Carcinoma..Verrucous","Ovarian.Torsion","CHARGE.Syndrome","Epilepsy..Reflex","Mast.Cell.Sarcoma","Legg.Calve.Perthes.Disease","Rectovaginal.Fistula","Cheilitis","Alcohol.Withdrawal.Delirium","Hypolipoproteinemias","Ebstein.Anomaly","Prehypertension","Blindness..Cortical","Myoglobinuria","Immunoglobulin.G4.Related.Disease","Holoprosencephaly","Blepharitis","Angiofibroma","Bovine.Virus.Diarrhea.Mucosal.Disease","Capsule.Opacification","Vitamin.B.6.Deficiency","Riboflavin.Deficiency","Atrial.Premature.Complexes","Morning.Sickness","Bronchopulmonary.Sequestration","Nails..Malformed","Mesonephroma","Arachnoiditis","Mucoepidermoid.Tumor","REM.Sleep.Parasomnias","Glaucoma..Neovascular","Porphyria.Cutanea.Tarda","Bone.Cysts..Aneurysmal","Pneumocephalus","Hyperemesis.Gravidarum","Corneal.Perforation","Ossification.of.Posterior.Longitudinal.Ligament","Tricuspid.Atresia","Twins..Conjoined","Hereditary.Sensory.and.Autonomic.Neuropathies","Leprosy..Tuberculoid","Leiomyomatosis","Limbic.Encephalitis","Angiodysplasia","Lens.Subluxation","Halitosis","Splenic.Infarction","Cataplexy","Oxyuriasis","White.Coat.Hypertension","Nystagmus..Congenital","Glycogen.Storage.Disease.Type.II","Wernicke.Encephalopathy","Still.s.Disease..Adult.Onset","Growth.Hormone.Secreting.Pituitary.Adenoma","Metatarsal.Valgus","Geographic.Atrophy","Thymus.Hyperplasia","Tetraploidy","Dental.Occlusion..Traumatic","Impetigo","Encephalitis..California","Bisphosphonate.Associated.Osteonecrosis.of.the.Jaw","Gigantism","Subclavian.Steal.Syndrome","Molluscum.Contagiosum","Fasciculation","Cystadenoma..Serous","Osteochondromatosis","Nut.and.Peanut.Hypersensitivity","Anisometropia","Immune.Reconstitution.Inflammatory.Syndrome","Intraoperative.Awareness","Presbycusis","Leprosy..Paucibacillary","Paget.Disease..Extramammary","Rhabdomyosarcoma..Alveolar","Microsporidiosis","Periapical.Abscess","Antithrombin.III.Deficiency","Myositis..Inclusion.Body","Croup","Darier.Disease","Acanthamoeba.Keratitis","Premature.Ejaculation","Prurigo","Protein.C.Deficiency","Melanoma..Amelanotic","Tibial.Neuropathy","Ichthyosiform.Erythroderma..Congenital","Larva.Migrans","Neurofibromatosis.2","Mesenchymoma","Candidiasis..Cutaneous","Endocardial.Fibroelastosis","Gardner.Syndrome","Orbital.Cellulitis","Hamartoma.Syndrome..Multiple","Neonatal.Abstinence.Syndrome","Pseudoxanthoma.Elasticum","Dental.Fistula","Peritonitis..Tuberculous","Meningitis..Escherichia.coli","Vocal.Cord.Dysfunction","Epilepsy..Post.Traumatic","Duodenogastric.Reflux","Angelman.Syndrome","Diffuse.Axonal.Injury","Bronchogenic.Cyst","Pituitary.ACTH.Hypersecretion","Fused.Kidney","Post.Concussion.Syndrome","Choroid.Hemorrhage","Hernia..Diaphragmatic..Traumatic","Ventricular.Septal.Rupture","Univentricular.Heart","Basal.Ganglia.Hemorrhage","Mushroom.Poisoning","Idiopathic.Interstitial.Pneumonias","Heat.Exhaustion","Pseudopseudohypoparathyroidism","ACTH.Syndrome..Ectopic","Mastocytoma","Lymphogranuloma.Venereum","Pseudohypoparathyroidism","Salivary.Calculi","Hepatic.Veno.Occlusive.Disease","Posterior.Leukoencephalopathy.Syndrome","Akathisia..Drug.Induced","Tumor.Lysis.Syndrome","Adenoma..Chromophobe","Bloom.Syndrome","Abortion..Missed","Lymphangioleiomyomatosis","Conjunctivitis..Viral","Factor.VII.Deficiency","Atypical.Hemolytic.Uremic.Syndrome","Pinealoma","Entamoebiasis","Aphasia..Primary.Progressive","Iritis","Ganglion.Cysts","Kidney.Cortex.Necrosis","Tinea.Pedis","Lymphoma..Primary.Effusion","Ethmoid.Sinusitis","Microvascular.Angina","Osteoarthropathy..Secondary.Hypertrophic","Leukemia..Mast.Cell","Tracheitis","Fractures..Malunited","Bell.Palsy","Emaciation","Shellfish.Poisoning","Status.Asthmaticus","Stupor","Laryngopharyngeal.Reflux","Bartter.Syndrome","Cystadenocarcinoma..Papillary","Papilloma..Inverted","Keratoconjunctivitis.Sicca","Sinus.Arrest..Cardiac","Radicular.Cyst","Mucopolysaccharidosis.I","Aphakia..Postcataract","Furunculosis","Hepatic.Infarction","Periodontal.Cyst","Histiocytosis..Sinus","Hemangioma..Cavernous..Central.Nervous.System","Pneumatosis.Cystoides.Intestinalis","Lymphoma..Extranodal.NK.T.Cell","Pneumonia..Necrotizing","Diastema","Nevus..Blue","Sinoatrial.Block","Stenosis..Pulmonary.Vein","Pneumonia..Lipid","Tay.Sachs.Disease","Fibroma..Ossifying","Chylous.Ascites","Superior.Mesenteric.Artery.Syndrome","MELAS.Syndrome","Chromosome.Fragility","Hemorrhagic.Fever..Crimean","Pseudomyxoma.Peritonei","Cystinuria","Anti.N.Methyl.D.Aspartate.Receptor.Encephalitis","Opisthorchiasis","Abortion..Incomplete","Keratosis..Seborrheic","Fasciitis..Plantar","Gangliosidoses..GM2","Arthropathy..Neurogenic","Kernicterus","Aniridia","Lymphocele","MPTP.Poisoning","Amnesia..Retrograde","Sialorrhea","Breakthrough.Pain","Adenolymphoma","Protein.S.Deficiency","Meconium.Aspiration.Syndrome","Aphasia..Broca","Pyloric.Stenosis..Hypertrophic","Smoke.Inhalation.Injury","Beckwith.Wiedemann.Syndrome","Polychondritis..Relapsing","Achlorhydria","Fibrous.Dysplasia..Polyostotic","Myopia..Degenerative","Psoas.Abscess","Basal.Cell.Nevus.Syndrome","Andersen.Syndrome","Neoplasm.Micrometastasis","Dysgeusia","Sturge.Weber.Syndrome","Multiple.Endocrine.Neoplasia.Type.2a","Leishmaniasis..Mucocutaneous","Pouchitis","Lissencephaly","Adenocarcinoma..Scirrhous","Pierre.Robin.Syndrome","Ancylostomiasis","Brachial.Plexus.Neuritis","Pseudolymphoma","Reye.Syndrome","Enophthalmos","Albinism..Oculocutaneous","Stomach.Volvulus","Tachycardia..Ectopic.Atrial","Pick.Disease.of.the.Brain","Retinoschisis","Breast.Cyst","Neurodermatitis","Osteitis.Fibrosa.Cystica","Hemobilia","Hemangioendothelioma..Epithelioid","Fuchs..Endothelial.Dystrophy","Xerophthalmia","Kuru","Salivary.Gland.Calculi","Brain.Stem.Infarctions","Herpes.Zoster.Ophthalmicus","Oligomenorrhea","Persistent.Left.Superior.Vena.Cava","Iridocyclitis","Oral.Submucous.Fibrosis","Rocky.Mountain.Spotted.Fever","Abortion..Septic","Liver.Abscess..Pyogenic","Myoclonic.Epilepsies..Progressive","Rubella.Syndrome..Congenital","Diabetes.Insipidus..Nephrogenic","Shoulder.Dystocia","Wheat.Hypersensitivity","Adams.Stokes.Syndrome","Endarteritis","Compassion.Fatigue","Calciphylaxis","Cystadenoma..Papillary","Gastrinoma","Aortopulmonary.Septal.Defect","No.Reflow.Phenomenon","Cardiomyopathy..Hypertrophic..Familial","Opiate.Overdose","Giant.Cell.Tumor.of.Tendon.Sheath","Dementia..Multi.Infarct","Patellofemoral.Pain.Syndrome","Hyperoxaluria..Primary","Liposarcoma..Myxoid","Paronychia","Endodermal.Sinus.Tumor","Rhabdomyoma","Leukodystrophy..Metachromatic","Granuloma.Annulare","ACTH.Secreting.Pituitary.Adenoma","Spinal.Muscular.Atrophies.of.Childhood","Epiglottitis","Asthma..Aspirin.Induced","Tooth.Eruption..Ectopic","Glycosuria..Renal","Acrocephalosyndactylia","Uterine.Cervical.Incompetence","Lichen.Sclerosus.et.Atrophicus","Hyperesthesia","Peroneal.Neuropathies","Stomatitis..Denture","Embolism..Cholesterol","Triploidy","Arterio.Arterial.Fistula","Small.Fiber.Neuropathy","Ureterocele","Cystinosis","Thyroglossal.Cyst","Micrognathism","Lennox.Gastaut.Syndrome","Athetosis","Activated.Protein.C.Resistance","Phimosis","Periarthritis","Pellagra","Sarcocystosis","Aberrant.Crypt.Foci","Rhinitis..Atrophic","Thyroiditis..Subacute","Mucopolysaccharidosis.II","Histiocytic.Sarcoma","Aortic.Valve.Prolapse","Pituitary.Apoplexy","Anemia..Refractory..with.Excess.of.Blasts","Lymphangiomyoma","Optic.Nerve.Glioma","Synovitis..Pigmented.Villonodular","Haemonchiasis","Urticaria.Pigmentosa","Acantholysis","Crush.Syndrome","Manganese.Poisoning","Muscular.Dystrophy..Facioscapulohumeral","Myopathies..Structural..Congenital","CADASIL","Severe.Fever.with.Thrombocytopenia.Syndrome","Macroglossia","Sarcoma..Endometrial.Stromal","Exostoses..Multiple.Hereditary","Serositis","Port.Wine.Stain","Ganglioglioma","Paralyses..Familial.Periodic","Li.Fraumeni.Syndrome","Kartagener.Syndrome","Acalculous.Cholecystitis","Syphilis..Cutaneous","Leukoaraiosis","Thrombasthenia","Chediak.Higashi.Syndrome","Meningitis..Listeria","Body.Weight.Trajectory","Lymphangitis","Arthus.Reaction","Nasopharyngitis","Rectocele","Ophthalmoplegia..Chronic.Progressive.External","Fraser.Syndrome","Immunoblastic.Lymphadenopathy","Anaplasia","Lyme.Neuroborreliosis","Hypophysitis","Leprosy..Borderline","Flea.Infestations","Periostitis","Parakeratosis","Lymphangiectasis","Biliary.Dyskinesia","Cystocele","Anomia","Embolism..Amniotic.Fluid","HIV.Associated.Lipodystrophy.Syndrome","Cardio.Renal.Syndrome","Peritonsillar.Abscess","Cavernous.Sinus.Thrombosis","Spider.Bites","Herpes.Labialis","Maple.Syrup.Urine.Disease","Leukemia..Prolymphocytic","Gonadal.Dysgenesis..46.XY","Subphrenic.Abscess","Factor.XI.Deficiency","Infectious.Bovine.Rhinotracheitis","Tooth.Attrition","Glycogen.Storage.Disease.Type.I","Sudden.Unexpected.Death.in.Epilepsy","Odontoma","Kidney.Papillary.Necrosis","Cytochrome.c.Oxidase.Deficiency","Follicular.Cyst","Chondromatosis","Chondroblastoma","Myoclonic.Epilepsy..Juvenile","Asthenozoospermia","Myoepithelioma","Joint.Loose.Bodies","Angioedemas..Hereditary","Epidermolysis.Bullosa.Dystrophica","Burning.Mouth.Syndrome","Lassa.Fever","Pemphigoid..Benign.Mucous.Membrane","Sprue..Tropical","Choanal.Atresia","Entropion","Hemorrhagic.Septicemia","Dysautonomia..Familial","Post.Traumatic.Headache","Tendon.Entrapment","Fetomaternal.Transfusion","Paragonimiasis","Glossitis","De.Lange.Syndrome","Klippel.Trenaunay.Weber.Syndrome","Branchioma","Radial.Neuropathy","Leukemia..Megakaryoblastic..Acute","Bardet.Biedl.Syndrome","Amnesia..Anterograde","Staghorn.Calculi","Anticipation..Genetic","Implant.Capsular.Contracture","Fecal.Impaction","Sleep.Bruxism","Dermatitis..Phototoxic","Hypertensive.Retinopathy","Capillary.Leak.Syndrome","Postthrombotic.Syndrome","Polyendocrinopathies..Autoimmune","Preleukemia","Dental.Fissures","Lesch.Nyhan.Syndrome","Ocular.Hypotension","Diabetes.Insipidus..Neurogenic","Dandy.Walker.Syndrome","Hiccup","Near.Drowning","Uveomeningoencephalitic.Syndrome","Mucopolysaccharidosis.IV","POEMS.Syndrome","Thyroid.Crisis","Uveitis..Intermediate","Meningeal.Carcinomatosis","Vulvar.Lichen.Sclerosus","Obesity.Hypoventilation.Syndrome","Cryptogenic.Organizing.Pneumonia","Hypohidrosis","Basal.Ganglia.Cerebrovascular.Disease","Epilepsy..Partial..Motor","Meibomian.Gland.Dysfunction","Cafe.au.Lait.Spots","Mesenteric.Cyst","Cockayne.Syndrome","Machado.Joseph.Disease","Agraphia","Neurofibroma..Plexiform","Slipped.Capital.Femoral.Epiphyses","Brachydactyly","Ecthyma","Osteoblastoma","Erythema.Infectiosum","Failed.Back.Surgery.Syndrome","Encephalitis..St..Louis","Low.Tension.Glaucoma","Dental.Pulp.Calcification","Ear.Deformities..Acquired","Alkaptonuria","Neuroaxonal.Dystrophies","Persistent.Fetal.Circulation.Syndrome","Cystic.Adenomatoid.Malformation.of.Lung..Congenital","Miller.Fisher.Syndrome","Corneal.Wavefront.Aberration","Single.Umbilical.Artery","Hypophosphatasia","Cardiomyopathy..Alcoholic","Livedo.Reticularis","Scimitar.Syndrome","Impotence..Vasculogenic","Xanthogranuloma..Juvenile","Sulfatidosis","Anterior.Compartment.Syndrome","Hepatopulmonary.Syndrome","Subdural.Effusion","Sagittal.Sinus.Thrombosis","Balanitis","Polycystic.Kidney..Autosomal.Recessive","Tracheomalacia","Sleep.Paralysis","Hyperostosis..Diffuse.Idiopathic.Skeletal","Syphilis..Cardiovascular","Myocardial.Bridging","Rheumatoid.Nodule","Hyperlipoproteinemia.Type.IV","Symptom.Flare.Up","Dysplastic.Nevus.Syndrome","Porokeratosis","Syphilis..Latent","Fluoride.Poisoning","Malaria..Avian","Chondromatosis..Synovial","Empyema..Subdural","Equine.Infectious.Anemia","Leukemia..Myeloid..Accelerated.Phase","Locked.In.Syndrome","Glomus.Jugulare.Tumor","Spinal.Osteochondrosis","Sphenoid.Sinusitis","Optic.Atrophy..Hereditary..Leber","Hemoglobin.SC.Disease","Gliosarcoma","Polymicrogyria","Congenital.Hyperinsulinism","Myotonia.Congenita","Chancroid","Retropharyngeal.Abscess","Pulmonary.Veno.Occlusive.Disease","Oncogene.Addiction","Leber.Congenital.Amaurosis","Epilepsy..Rolandic","Klatskin.Tumor","Amelogenesis.Imperfecta","Pneumopericardium","Colonic.Pseudo.Obstruction","Chromoblastomycosis","Ichthyosis..Lamellar","Hyperlipoproteinemia.Type.III","Gastroenteritis..Transmissible..of.Swine","Cerebrospinal.Fluid.Otorrhea","Anophthalmos","Pyomyositis","Empty.Sella.Syndrome","Fibromatosis..Abdominal","Chondrodysplasia.Punctata","Eisenmenger.Complex","Tooth.Ankylosis","Staphylococcal.Food.Poisoning","Parapsoriasis","Incontinentia.Pigmenti","Femoral.Neuropathy","Nevus..Spindle.Cell","Lead.Poisoning..Nervous.System","Mercury.Poisoning..Nervous.System","Opioid.Induced.Constipation","Fournier.Gangrene","Clonorchiasis","Tinea.Versicolor","Cowpox","Salivary.Duct.Calculi","Empyema..Tuberculous","Carney.Complex","Shwartzman.Phenomenon","Postural.Orthostatic.Tachycardia.Syndrome","Periodontal.Abscess","Cleidocranial.Dysplasia","Chondrosarcoma..Mesenchymal","Orbital.Pseudotumor","Dyskeratosis.Congenita","Erdheim.Chester.Disease","Furcation.Defects","Dyslexia..Acquired","Atypical.Squamous.Cells.of.the.Cervix","Trypanosomiasis..Bovine","Lymphoma..Large.Cell..Immunoblastic","Familial.Hypophosphatemic.Rickets","Hyperamylasemia","Myelinolysis..Central.Pontine","Hypoprothrombinemias","Rinderpest","Epispadias","Waardenburg.Syndrome","Pregnancy..Heterotopic","Earache","Hereditary.Breast.and.Ovarian.Cancer.Syndrome","Buruli.Ulcer","Gingivitis..Necrotizing.Ulcerative","Lambert.Eaton.Myasthenic.Syndrome","Mucolipidoses","Post.Dural.Puncture.Headache","Hyperlactatemia","Transfusion.Related.Acute.Lung.Injury","Lupus.Vasculitis..Central.Nervous.System","Asthenopia","Colitis..Collagenous","Hypokalemic.Periodic.Paralysis","Klippel.Feil.Syndrome","Yaws","Osteolysis..Essential","Optic.Nerve.Hypoplasia","Neurogenic.Bowel","Marburg.Virus.Disease","Adenomatoid.Tumor","Leukodystrophy..Globoid.Cell","Supraglottitis","Intracranial.Hemorrhage..Hypertensive","Bone.Anteversion","Alcohol.Amnestic.Disorder","Farmer.s.Lung","Hematoma..Subdural..Spinal","Autoimmune.Lymphoproliferative.Syndrome","Diphyllobothriasis","Zenker.Diverticulum","Zellweger.Syndrome","Anthracosis","Stargardt.Disease","Accessory.Atrioventricular.Bundle","HIV.Wasting.Syndrome","Amnesia..Transient.Global","Chronic.Traumatic.Encephalopathy","Hyperferritinemia","Hypoadrenocorticism..Familial","Massive.Hepatic.Necrosis","Leukemoid.Reaction","Tuberculosis..Laryngeal","Myelolipoma","Visna","Goldenhar.Syndrome","Proctocolitis","Hymenolepiasis","Truncus.Arteriosus..Persistent","Ageusia","Premenstrual.Dysphoric.Disorder","Diaphragmatic.Eventration","Bovine.Respiratory.Disease.Complex","Angiokeratoma","Hyperacusis","Labyrinthitis","Leukorrhea","Prosopagnosia","Scorpion.Stings","Cutis.Laxa","Korsakoff.Syndrome","Uterine.Inertia","Lathyrism","Congenital.Microtia","Factor.XIII.Deficiency","Candidiasis..Chronic.Mucocutaneous","Facial.Hemiatrophy","Anisakiasis","Glucagonoma","Cor.Triatriatum","Systolic.Murmurs","Upper.Extremity.Deep.Vein.Thrombosis","Flail.Chest","Plagiocephaly","Pancreatitis..Acute.Hemorrhagic","Alagille.Syndrome","Cubital.Tunnel.Syndrome","Alcohol.Withdrawal.Seizures","Goiter..Substernal","Conjunctivitis..Inclusion","Papilloma..Intraductal","Purpura.Fulminans","Periapical.Granuloma","Amaurosis.Fugax","Stomatitis..Herpetic","Fructose.Intolerance","Autonomic.Dysreflexia","Papilloma..Choroid.Plexus","Salter.Harris.Fractures","Anisocoria","Prostatism","Retinal.Telangiectasis","Hip.Contracture","Popliteal.Cyst","Megacolon..Toxic","Dry.Socket","Neuritis..Autoimmune..Experimental","Protoporphyria..Erythropoietic","Aphasia..Wernicke","Tuberculosis..Male.Genital","Dentofacial.Deformities","Enterobiasis","Ochronosis","Hantavirus.Pulmonary.Syndrome","Anemia..Diamond.Blackfan","Mucopolysaccharidosis.III","Pyelonephritis..Xanthogranulomatous","Erythema.Chronicum.Migrans","Oroantral.Fistula","Aicardi.Syndrome","Thecoma","Pyometra","Borna.Disease","Colles..Fracture","Beriberi","Intrauterine.Device.Migration","Phaeohyphomycosis","Colloid.Cysts","Tuberculosis..Splenic","Hyperlipidemia..Familial.Combined","Menkes.Kinky.Hair.Syndrome","Kallmann.Syndrome","Encephalomyelitis..Venezuelan.Equine","Stiff.Person.Syndrome","Intraocular.Lymphoma","Paget.s.Disease..Mammary","Retinal.Dysplasia","Epidermolysis.Bullosa.Acquisita","Anticholinergic.Syndrome","Ophthalmia..Sympathetic","Histiocytic.Necrotizing.Lymphadenitis","Rhinitis..Vasomotor","Vulvodynia","Heterotaxy.Syndrome","Thyroid.Dysgenesis","Bulbar.Palsy..Progressive","Cheyne.Stokes.Respiration","Malacoplakia","Reticulocytosis","Laryngismus","Diverticulum..Stomach","Lymphomatoid.Papulosis","Nevus..Epithelioid.and.Spindle.Cell","Hemopneumothorax","Hypoalphalipoproteinemias","Piedra","Thrombocytopenia..Neonatal.Alloimmune","Metatarsalgia","Extranodal.Extension","Myasthenia.Gravis..Autoimmune..Experimental","Refsum.Disease","Thyroid.Hormone.Resistance.Syndrome","Tuberculoma..Intracranial","Pilomatrixoma","Lateral.Medullary.Syndrome","Hypervitaminosis.A","Feline.Acquired.Immunodeficiency.Syndrome","Mixed.Tumor..Mullerian","Necrobiosis.Lipoidica","Ornithine.Carbamoyltransferase.Deficiency.Disease","Multicystic.Dysplastic.Kidney","Vestibular.Neuronitis","Trichiasis","Focal.Epithelial.Hyperplasia","Emergence.Delirium","Sick.Building.Syndrome","Cerebral.Cortical.Thinning","Endocardial.Cushion.Defects","Pericarditis..Tuberculous","Kearns.Sayre.Syndrome","Fused.Teeth","Epidermolysis.Bullosa.Simplex","Persian.Gulf.Syndrome","Syringoma","Sepsis.Associated.Encephalopathy","Sarcoma..Alveolar.Soft.Part","Shaken.Baby.Syndrome","Niemann.Pick.Disease..Type.C","Space.Motion.Sickness","Ostertagiasis","Esthesioneuroblastoma..Olfactory","Factor.XII.Deficiency","Lymphomatoid.Granulomatosis","Factor.V.Deficiency","Pityriasis.Rubra.Pilaris","Panniculitis..Nodular.Nonsuppurative","Poliomyelitis..Bulbar","Granuloma..Respiratory.Tract","Dracunculiasis","Colitis..Lymphocytic","Enzootic.Bovine.Leukosis","Enthesopathy","Larva.Migrans..Visceral","Causalgia","Hydatidiform.Mole..Invasive","Melkersson.Rosenthal.Syndrome","AIDS.Associated.Nephropathy","Megalencephaly","Equinus.Deformity","Porphyria..Erythropoietic","Myotoxicity","Peste.des.Petits.Ruminants","Epidermolysis.Bullosa..Junctional","Ischemic.Contracture","Esophageal.Cyst","Acute.Generalized.Exanthematous.Pustulosis","Mesenteric.Lymphadenitis","Boutonneuse.Fever","Gangliosidosis..GM1","Leukemia..Basophilic..Acute","Ganglioneuroblastoma","Synkinesis","Tracheobronchomalacia","Hypobetalipoproteinemias","Albinism..Ocular","Encephalitis..Varicella.Zoster","Berylliosis","Fowlpox","Carcinoid.Heart.Disease","Isolated.Noncompaction.of.the.Ventricular.Myocardium","Erythromelalgia","Plasmablastic.Lymphoma","Osteoarthropathy..Primary.Hypertrophic","Caroli.Disease","Gagging","Arachnodactyly","Ectopia.Lentis","Hyperthyroxinemia","Epidermodysplasia.Verruciformis","Tabes.Dorsalis","Adenocarcinoma..Sebaceous","Paralysis..Obstetric","Smith.Lemli.Opitz.Syndrome","Enchondromatosis","Nails..Ingrown","Genu.Valgum","Neurocytoma","Feline.Infectious.Peritonitis","Scheuermann.Disease","Dystonia.Musculorum.Deformans","Pseudohypoaldosteronism","Fusariosis","Multiple.Endocrine.Neoplasia.Type.2b","Meconium.Ileus","Anemia..Hemolytic..Congenital.Nonspherocytic","Encopresis","Barth.Syndrome","Hearing.Loss..Mixed.Conductive.Sensorineural","Pleuropneumonia..Contagious","Leukemia.L5178","Laryngomalacia","Dermatitis..Photoallergic","Postpoliomyelitis.Syndrome","Diaper.Rash","Ophthalmia.Neonatorum","Angioid.Streaks","Prune.Belly.Syndrome","Leukemia..Myelomonocytic..Juvenile","Retinal.Necrosis.Syndrome..Acute","Gonadoblastoma","Hallux.Rigidus","Costello.Syndrome","Rhinoscleroma","Muscular.Dystrophy..Emery.Dreifuss","Sphincter.of.Oddi.Dysfunction","Elliptocytosis..Hereditary","Phencyclidine.Abuse","Battered.Child.Syndrome","Chancre","Tuberculosis..Avian","Tetrasomy","Proteus.Syndrome","Sweating..Gustatory","Amniotic.Band.Syndrome","Silicotuberculosis","Wolfram.Syndrome","Congenitally.Corrected.Transposition.of.the.Great.Arteries","Trichostrongylosis","Callosities","Adenomyoma","Uterine.Inversion","Paraneoplastic.Cerebellar.Degeneration","Silver.Russell.Syndrome","Nasal.Septal.Perforation","Vitamin.K.Deficiency.Bleeding","Hyperglycemic.Hyperosmolar.Nonketotic.Coma","Edema.Disease.of.Swine","Urinoma","Coxa.Vara","Leukemia..Large.Granular.Lymphocytic","Pancoast.Syndrome","Granulomatous.Mastitis","Coma..Post.Head.Injury","Teratozoospermia","Leukemia..Prolymphocytic..T.Cell","Jaundice..Chronic.Idiopathic","Leukoplakia..Hairy","Pityriasis.Rosea","Tangier.Disease","Diffuse.Intrinsic.Pontine.Glioma","Tarsal.Tunnel.Syndrome","Gerstmann.Syndrome","Ciguatera.Poisoning","Typhus..Endemic.Flea.Borne","Hyalohyphomycosis","Hutchinson.s.Melanotic.Freckle","Splenosis","Gastritis..Hypertrophic","Mucopolysaccharidosis.VI","Adamantinoma","Sandhoff.Disease","Murine.Acquired.Immunodeficiency.Syndrome","Postphlebitic.Syndrome","Meigs.Syndrome","Rubinstein.Taybi.Syndrome","Foot.Rot","Lingual.Thyroid","Granuloma..Laryngeal","Cri.du.Chat.Syndrome","Tuberculosis..Endocrine","Blepharophimosis","Byssinosis","Tertiary.Lymphoid.Structures","Dentinogenesis.Imperfecta","Bankart.Lesions","Kasabach.Merritt.Syndrome","Gitelman.Syndrome","Nut.Hypersensitivity","Loiasis","Xanthomatosis..Cerebrotendinous","Chilblains","Smoldering.Multiple.Myeloma","Pancreatitis..Graft","Leukemia..Biphenotypic..Acute","Felty.Syndrome","Somnambulism","Desmoplastic.Small.Round.Cell.Tumor","Dyspnea..Paroxysmal","Semicircular.Canal.Dehiscence","Akinetic.Mutism","Keratoconjunctivitis..Infectious","Platelet.Storage.Pool.Deficiency","Pulmonary.Blastoma","Struma.Ovarii","Duane.Retraction.Syndrome","Refeeding.Syndrome","Distal.Myopathies","Sertoli.Cell.Only.Syndrome","Birt.Hogg.Dube.Syndrome","Mallory.Weiss.Syndrome","Bernard.Soulier.Syndrome","Post.Cardiac.Arrest.Syndrome","Pain.Insensitivity..Congenital","Tonic.Pupil","Hypoaldosteronism","Lymphoma..Primary.Cutaneous.Anaplastic.Large.Cell","Onchocerciasis..Ocular","Hernia..Obturator","Loeys.Dietz.Syndrome","Anemia..Dyserythropoietic..Congenital","Abetalipoproteinemia","Genu.Varum","Onycholysis","Cervical.Rib.Syndrome","Bunion","Pyonephrosis","Opsoclonus.Myoclonus.Syndrome","Retropneumoperitoneum","Myokymia","Myopathies..Nemaline","Shy.Drager.Syndrome","Optic.Disk.Drusen","Ecthyma..Contagious","delta.Thalassemia","Nocturnal.Myoclonus.Syndrome","Cerebral.Ventriculitis","Encephalomyelitis..Eastern.Equine","Rothmund.Thomson.Syndrome","Composite.Lymphoma","Fibrous.Dysplasia..Monostotic","Lecithin.Cholesterol.Acyltransferase.Deficiency","African.Horse.Sickness","Propionic.Acidemia","Pantothenate.Kinase.Associated.Neurodegeneration","Angiomatosis..Bacillary","Gerstmann.Straussler.Scheinker.Disease","Balkan.Nephropathy","Pemphigoid.Gestationis","High.Pressure.Neurological.Syndrome","Leriche.Syndrome","Kounis.Syndrome","Lynch.Syndrome.II","Digital.Dermatitis","Trigger.Finger.Disorder","Oophoritis","Jet.Lag.Syndrome","Lymphangiectasis..Intestinal","Microstomia","Encephalomyelitis..Western.Equine","Leukemia..Prolymphocytic..B.Cell","Hip.Dysplasia..Canine","Pelizaeus.Merzbacher.Disease","Actinomycosis..Cervicofacial","Hydrophthalmos","Olivopontocerebellar.Atrophies","Swine.Vesicular.Disease","Citrullinemia","Glycogen.Storage.Disease.Type.V","Eunuchism","Esophageal.Spasm..Diffuse","Optic.Atrophy..Autosomal.Dominant","Dyscalculia","Cone.Rod.Dystrophies","Favism","Isochromosomes","Ichthyosis..X.Linked","Feline.Panleukopenia","May.Thurner.Syndrome","Nijmegen.Breakage.Syndrome","Cephalopelvic.Disproportion","Trisomy.18.Syndrome","Bone.Demineralization..Pathologic","Pregnancy..Cornual","Krukenberg.Tumor","Brown.Sequard.Syndrome","Hemorrhagic.Fever..American","Angiolipoma","Hyperostosis..Cortical..Congenital","Leukostasis","Ranula","Pemphigus..Benign.Familial","Granuloma.Inguinale","Lemierre.Syndrome","Platybasia","Gingival.Hypertrophy","Neurofibrosarcoma","Solitary.Fibrous.Tumor..Pleural","Urachal.Cyst","Pruritus.Ani","Subacute.Combined.Degeneration","Linear.IgA.Bullous.Dermatosis","Sparganosis","Uterine.Cervical.Erosion","Herpes.Zoster.Oticus","Biotinidase.Deficiency","Nephroma..Mesoblastic","Dandruff","Diastasis..Bone","Blind.Loop.Syndrome","Autoimmune.Hypophysitis","Choroideremia","Hyperkeratosis..Epidermolytic","Kaposi.Varicelliform.Eruption","Adenosarcoma","Lateral.Sinus.Thrombosis","Rhinosporidiosis","Carcinoma..Basosquamous","Hallux.Varus","Tricuspid.Valve.Prolapse","Lipomatosis..Multiple.Symmetrical","Latent.Autoimmune.Diabetes.in.Adults","Retrobulbar.Hemorrhage","Tick.Paralysis","Arteriolosclerosis","Muscular.Dystrophy..Oculopharyngeal","Pericoronitis","Ellis.Van.Creveld.Syndrome","Chalazion","Epilepsy..Benign.Neonatal","Skull.Fracture..Depressed","Vitelliform.Macular.Dystrophy","Hemorrhagic.Septicemia..Viral","Hyperostosis.Frontalis.Interna","Hyperlipoproteinemia.Type.I","Hydranencephaly","Tachycardia..Ectopic.Junctional","Wandering.Spleen","Crigler.Najjar.Syndrome","Fibromatosis..Gingival","Epilepsia.Partialis.Continua","Ankyloglossia","Inhalant.Abuse","Hand.Arm.Vibration.Syndrome","Nephrogenic.Fibrosing.Dermopathy","Multiple.Carboxylase.Deficiency","Trophoblastic.Tumor..Placental.Site","Medullary.Sponge.Kidney","Ergotism","Laurence.Moon.Syndrome","Pityriasis.Lichenoides","Rhinophyma","Pelvic.Girdle.Pain","Staphylococcal.Scalded.Skin.Syndrome","Leukocyte.Adhesion.Deficiency.Syndrome","Isaacs.Syndrome","Cardiac.Papillary.Fibroelastoma","Hemoglobin.C.Disease","Factor.X.Deficiency","Bone.Retroversion","Nesidioblastosis","Interatrial.Block","Aphonia","Linitis.Plastica","Nail.Patella.Syndrome","Carbuncle","Choriocarcinoma..Non.gestational","XYY.Karyotype","Reticuloendotheliosis..Avian","Canavan.Disease","Synesthesia","Angiomyoma","Vipoma","Postcholecystectomy.Syndrome","Lafora.Disease","Acrospiroma","Nevus..Intradermal","Porencephaly","Multifocal.Choroiditis","Salivary.Gland.Fistula","Hematometra","Trisomy.13.Syndrome","Eosinophilia.Myalgia.Syndrome","Ichthyosis.Vulgaris","Chemotherapy.Related.Cognitive.Impairment","Nevus.of.Ota","Carcinoma..Skin.Appendage","Orbital.Myositis","Chromothripsis","Acanthoma","Dens.in.Dente","Eructation","Glycogen.Storage.Disease.Type.III","Dendritic.Cell.Sarcoma..Follicular","Craniofacial.Fibrous.Dysplasia","Pectus.Carinatum","Hematocolpos","Rigor.Mortis","Chlamydial.Pneumonia","Pyruvate.Dehydrogenase.Complex.Deficiency.Disease","Bird.Fancier.s.Lung","Positive.Pressure.Respiration..Intrinsic","Cogan.Syndrome","Poroma","Sotos.Syndrome","Peliosis.Hepatis","Erythroplasia","Hemimegalencephaly","Tolosa.Hunt.Syndrome","Gonadal.Dysgenesis..Mixed","Panophthalmitis","Wolf.Hirschhorn.Syndrome","Mirizzi.Syndrome","Dermatitis..Perioral","Argyria","Acquired.Hyperostosis.Syndrome","Intertrigo","Glanders","MERRF.Syndrome","Phlebotomus.Fever","Leukemia..Neutrophilic..Chronic","Mobius.Syndrome","Shellfish.Hypersensitivity","Hydropneumothorax","Anemia..Myelophthisic","Exanthema.Subitum","Scleromyxedema","Cherubism","Septo.Optic.Dysplasia","Pasteurellosis..Pneumonic","Paraneoplastic.Polyneuropathy","Microaneurysm","Microvascular.Rarefaction","Waterhouse.Friderichsen.Syndrome","Granuloma..Lethal.Midline","Smith.Magenis.Syndrome","Nonodontogenic.Cysts","Aniseikonia","Pneumonia.of.Swine..Mycoplasmal","Meningism","Postpartum.Thyroiditis","Acro.Osteolysis","Gastric.Antral.Vascular.Ectasia","Miliaria","Shwachman.Diamond.Syndrome","Pure.Autonomic.Failure","Pseudobulbar.Palsy","Phenylketonuria..Maternal","Enteropathy.Associated.T.Cell.Lymphoma","Quadricuspid.Aortic.Valve","Heartwater.Disease","Muir.Torre.Syndrome","Afferent.Loop.Syndrome","Renal.Nutcracker.Syndrome","Thanatophoric.Dysplasia","Vasoplegia","Parkinson.Disease..Postencephalitic","Landau.Kleffner.Syndrome","Encephalitozoonosis","Insomnia..Fatal.Familial","Adenoma..Acidophil","Rotator.Cuff.Tear.Arthropathy","Posterior.Tibial.Tendon.Dysfunction","Thyroiditis..Suppurative","Adenomatosis..Pulmonary","Enterocolitis..Neutropenic","Mesial.Movement.of.Teeth","Tongue..Hairy","Spina.Bifida.Cystica","Odontogenic.Cyst..Calcifying","Osteopoikilosis","Anthracosilicosis","Alcoholic.Neuropathy","Lumpy.Skin.Disease","Myofibromatosis","Pruritus.Vulvae","Swine.Erysipelas","Typhlitis","Cholesterol.Ester.Storage.Disease","Aleutian.Mink.Disease","Cementoma","Pachyonychia.Congenita","Striae.Distensae","Tarsal.Coalition","Transient.Tachypnea.of.the.Newborn","Persistent.Hyperplastic.Primary.Vitreous","Nuchal.Cord","Laron.Syndrome","Leukemia..Myeloid..Chronic..Atypical..BCR.ABL.Negative","Kleine.Levin.Syndrome","Monteggia.s.Fracture","Lymphangiosarcoma","Schizencephaly","Apraxia..Ideomotor","Tyrosinemias","Panniculitis..Lupus.Erythematosus","Median.Arcuate.Ligament.Syndrome","Idiopathic.Hypersomnia","Erysipeloid","Ludwig.s.Angina","Myofibroma","Acute.Febrile.Encephalopathy","Cellulite","Enterotoxemia","Putaminal.Hemorrhage","Panniculitis..Peritoneal","Primary.Progressive.Nonfluent.Aphasia","Hyper.IgM.Immunodeficiency.Syndrome","LEOPARD.Syndrome","Tongue..Fissured","Fibroma..Desmoplastic","Pulmonary.Subvalvular.Stenosis","Immersion.Foot","Charles.Bonnet.Syndrome","Obesity..Metabolically.Benign","Oculocerebrorenal.Syndrome","Lipodystrophy..Congenital.Generalized","Myxosarcoma","Melorheostosis","Laryngocele","Lipoblastoma","Apudoma","Carcinoma..Krebs.2","Postpericardiotomy.Syndrome","Leishmaniasis..Diffuse.Cutaneous","Porcine.Postweaning.Multisystemic.Wasting.Syndrome","Mevalonate.Kinase.Deficiency","Walker.Warburg.Syndrome","Wolman.Disease","Papillon.Lefevre.Disease","Hepatitis.D..Chronic","Dermatitis..Toxicodendron","Tinea.cruris","Plasma.Cell.Granuloma..Pulmonary","Vaginismus","Parturient.Paresis","Anterior.Spinal.Artery.Syndrome","Mesothelioma..Cystic","Paroxysmal.Hemicrania","Dihydropyrimidine.Dehydrogenase.Deficiency","Langerhans.Cell.Sarcoma","Urinary.Bladder..Underactive","Mucopolysaccharidosis.VII","Vomiting..Anticipatory","Acrodynia","Opium.Dependence","Kashin.Beck.Disease","Hyperekplexia","Somatostatinoma","Lipoid.Proteinosis.of.Urbach.and.Wiethe","Nevus..Sebaceous.of.Jadassohn","Coronary.Subclavian.Steal.Syndrome","Netherton.Syndrome","Mucinosis..Follicular","Focal.Dermal.Hypoplasia","Myocardial.Contusions","Retrocaval.Ureter","alpha.Mannosidosis","Acute.Retroviral.Syndrome","Mixed.Tumor..Mesodermal","Mikulicz..Disease","Popliteal.Artery.Entrapment.Syndrome","Ascaridiasis","Porphyria..Variegate","Hyperglycinemia..Nonketotic","Pinta","Hermanski.Pudlak.Syndrome","Periventricular.Nodular.Heterotopia","Gnathostomiasis","Discrete.Subaortic.Stenosis","Malignant.Catarrh","Parasystole","Post.Exercise.Hypotension","Glossitis..Benign.Migratory","Leukoencephalitis..Acute.Hemorrhagic","Pelger.Huet.Anomaly","Scleredema.Adultorum","Toxic.Optic.Neuropathy","Sjogren.Larsson.Syndrome","Necatoriasis","Meige.Syndrome","Ectromelia..Infectious","Eccrine.Porocarcinoma","Rheumatic.Nodule","Skull.Fracture..Basilar","Keratoderma..Palmoplantar..Diffuse","Mastodynia","Propofol.Infusion.Syndrome","Adrenal.Rest.Tumor","Neuroectodermal.Tumor..Melanotic","Schnitzler.Syndrome","Striatonigral.Degeneration","Lipodystrophy..Familial.Partial","De.Quervain.Disease","Chronic.Exertional.Compartment.Syndrome","Myopathy..Central.Core","Uveitis..Suppurative","Susac.Syndrome","Delayed.Emergence.from.Anesthesia","Oesophagostomiasis","Pneumonia..Progressive.Interstitial..of.Sheep","Paralysis..Hyperkalemic.Periodic","Echolalia","Dentin.Dysplasia","Gonadal.Dysgenesis..46.XX","Emphysematous.Cholecystitis","Bilateral.Vestibulopathy","Night.Terrors","Ectopia.Cordis","Leukemia..Eosinophilic..Acute","Yellow.Nail.Syndrome","Leiomyoma..Epithelioid","Alstrom.Syndrome","Bland.White.Garland.Syndrome","Piebaldism","Bronchomalacia","Romano.Ward.Syndrome","Tietze.s.Syndrome","Gyrate.Atrophy","Tick.Toxicoses","Rat.Bite.Fever","Visceral.Prolapse","Iliotibial.Band.Syndrome","Adie.Syndrome","Caplan.Syndrome","Gait.Apraxia","Carcinoma..Brown.Pearce","Glioma..Subependymal","Metatarsus.Varus","Lead.Poisoning..Nervous.System..Adult","Sarcoma.37","Plagiocephaly..Nonsynostotic","Asthma.Chronic.Obstructive.Pulmonary.Disease.Overlap.Syndrome","DNA.Degradation..Necrotic","Paraduodenal.Hernia","Branchio.Oto.Renal.Syndrome","Respiratory.Aspiration.of.Gastric.Contents","Glossoptosis","Neuroacanthocytosis","Liddle.Syndrome","Chondromalacia.Patellae","Acne.Conglobata","Hepatitis..Infectious.Canine","Hydrarthrosis","Balantidiasis","Herpangina","Pleurodynia..Epidemic","Heel.Spur","Nevus..Halo","Lung..Hyperlucent","Spermatocele","Hidrocystoma","Lipedema","Eczema..Dyshidrotic","Trench.Fever","Mastocytoma..Skin","Nicolau.Syndrome","Piriformis.Muscle.Syndrome","Otomycosis","Odontodysplasia","Hydroa.Vacciniforme","Erythema.Induratum","Coxa.Valga","Tungiasis","Pancreaticobiliary.Maljunction","Pythiosis","Diurnal.Enuresis","Anetoderma","Trichosporonosis","Isosporiasis","Fucosidosis","Camurati.Engelmann.Syndrome","Pars.Planitis","Inert.Gas.Narcosis","Hypodermyiasis","Conjunctivitis..Acute.Hemorrhagic","Sneddon.Syndrome","Vulvar.Vestibulitis","Cyclosporiasis","Neonatal.Brachial.Plexus.Palsy","Pycnodysostosis","Echogenic.Bowel","Plummer.Vinson.Syndrome","Cerebral.Amyloid.Angiopathy..Familial","Hemospermia","Neurolymphomatosis","Necrolytic.Migratory.Erythema","Echinostomiasis","Denys.Drash.Syndrome","Aphasia..Conduction","Coproporphyria..Hereditary","Glycogen.Storage.Disease.Type.IV","Chondrodysplasia.Punctata..Rhizomelic","Decalcification..Pathologic","Pubic.Symphysis.Diastasis","Mineralocorticoid.Excess.Syndrome..Apparent","Vasa.Previa","Ephemeral.Fever","Epilepsy..Partial..Sensory","SUNCT.Syndrome","Tarlov.Cysts","Chloracne","Pulmonary.Sclerosing.Hemangioma","T.Lymphocytopenia..Idiopathic.CD4.Positive","HIV.Enteropathy","Neurothekeoma","Glossalgia","Alexia..Pure","Tracheobronchomegaly","Acne.Keloid","Jervell.Lange.Nielsen.Syndrome","Necrobiotic.Xanthogranuloma","Lichen.Nitidus","Sister.Mary.Joseph.s.Nodule","Granulomatosis..Orofacial","Pentalogy.of.Cantrell","Sialometaplasia..Necrotizing","Marchiafava.Bignami.Disease","Atrophic.Vaginitis","Odontogenic.Tumor..Squamous","Argininosuccinic.Aciduria","Birdshot.Chorioretinopathy","Gynatresia","Aerophagy","Cracked.Tooth.Syndrome","Hematocele","Accelerated.Idioventricular.Rhythm","GATA2.Deficiency","Iridocorneal.Endothelial.Syndrome","Campomelic.Dysplasia","Diabetes.Mellitus..Lipoatrophic","Alcoholic.Korsakoff.Syndrome","Hydrocolpos","Louping.Ill","Giant.Axonal.Neuropathy","Pudendal.Neuralgia","Purpura..Hyperglobulinemic","Neuroaspergillosis","Rumination.Syndrome","Levocardia","Myasthenia.Gravis..Neonatal","Hyperargininemia","Perinephritis","Hammer.Toe.Syndrome","Arcus.Senilis","Malignant.Atrophic.Papulosis","Polydipsia..Psychogenic","Macrostomia","Hartnup.Disease","Artificial.Lens.Implant.Migration","Sunstroke","Buschke.Lowenstein.Tumor","von.Willebrand.Disease..Type.1","Adenomyoepithelioma","Medial.Tibial.Stress.Syndrome","Kluver.Bucy.Syndrome","Abducens.Nerve.Injury","Balanitis.Xerotica.Obliterans","Steatocystoma.Multiplex","Dicrocoeliasis","Colorado.Tick.Fever","Mansonelliasis","Myxomatosis..Infectious","Chondrosarcoma..Clear.Cell","Ophthalmoplegic.Migraine","Choroidal.Effusions","Pulmonary.Adenomatosis..Ovine","Parametritis","Tinea.Favosa","Cobblestone.Lissencephaly","Blackwater.Fever","von.Willebrand.Disease..Type.2","Kyasanur.Forest.Disease","Ectodermal.Dysplasia.1..Anhidrotic","Short.Rib.Polydactyly.Syndrome","Alien.Hand.Syndrome","Porphyria..Hepatoerythropoietic","Hyperlipoproteinemia.Type.V","Reinjuries","Commotio.Cordis","Gray.Platelet.Syndrome","Hypertriglyceridemic.Waist","Sialic.Acid.Storage.Disease","WAGR.Syndrome","Ainhum","Hamman.Rich.Syndrome","Myoclonic.Cerebellar.Dyssynergia","Coffin.Lowry.Syndrome","Canaliculitis","Acatalasia","Parovarian.Cyst","Pyelectasis","Glomus.Tympanicum.Tumor","Langer.Giedion.Syndrome","X.Linked.Emery.Dreifuss.Muscular.Dystrophy","Chilaiditi.Syndrome","Immunoproliferative.Small.Intestinal.Disease","Brain.Stem.Hemorrhage..Traumatic","Keratoderma..Palmoplantar..Epidermolytic","Bulbo.Spinal.Atrophy..X.Linked","Paraphimosis","Erythrasma","Lead.Poisoning..Nervous.System..Childhood","Pregnancy..Angular","Multiple.Acyl.Coenzyme.A.Dehydrogenase.Deficiency","Pneumorrhachis","Cystadenofibroma","Prolidase.Deficiency","Donohue.Syndrome","Monilethrix","Post.Lyme.Disease.Syndrome","Alternariosis","Myringosclerosis","Blue.Toe.Syndrome","Warburg.Effect..Oncologic","Familial.Exudative.Vitreoretinopathies","Diastasis..Muscle","Fibromatosis..Plantar","Aspartylglucosaminuria","Geotrichosis","Myopericytoma","Screw.Worm.Infection","Nodding.Syndrome","Luteoma","Freemartinism","Tachycardia..Sinoatrial.Nodal.Reentry","Hyalinosis..Systemic","Hajdu.Cheney.Syndrome","Hallermann.s.Syndrome","Retinal.Arterial.Macroaneurysm","Adiposis.Dolorosa","Neuroschistosomiasis","Glycogen.Storage.Disease.Type.IIb","Non.Filarial.Lymphedema","Sinus.Pericranii","Mammary.Analogue.Secretory.Carcinoma","Unverricht.Lundborg.Syndrome","Slit.Ventricle.Syndrome","Sclerema.Neonatorum","Osteosarcoma..Juxtacortical","Uterine.Retroversion","Mongolian.Spot","Morton.Neuroma","Hordeolum","Autosomal.Emery.Dreifuss.Muscular.Dystrophy","Nairobi.Sheep.Disease","Hallux.Limitus","Refsum.Disease..Infantile","Uveal.Effusion.Syndrome","Aspermia","Lutembacher.Syndrome","Classical.Lissencephalies.and.Subcortical.Band.Heterotopias","Pallister.Hall.Syndrome","Adenoma..Basophil","Hyperostosis..Sternocostoclavicular","Petrositis","Sarcoglycanopathies","Dendritic.Cell.Sarcoma..Interdigitating","Pyruvate.Carboxylase.Deficiency.Disease","Posterior.Capsular.Rupture..Ocular","Hereditary.Angioedema.Types.I.and.II","Fox.Fordyce.Disease","Pinguecula","Weill.Marchesani.Syndrome","Hypercementosis","Frasier.Syndrome","Pneumonia..Rickettsial","Wissler.s.Syndrome","beta.Mannosidosis","Dientamoebiasis","Cerebral.Phaeohyphomycosis","Zoster.Sine.Herpete","Alice.in.Wonderland.Syndrome","Erythrokeratodermia.Variabilis","Setariasis","Acrocallosal.Syndrome","Chiari.Frommel.Syndrome","Lobomycosis","Aortico.Ventricular.Tunnel","Holocarboxylase.Synthetase.Deficiency","Central.Nervous.System.Venous.Angioma","Microtrauma..Physical","Pott.Puffy.Tumor","Monieziasis","Milk.Sickness","Talipes.Cavus","Multiple.Sulfatase.Deficiency.Disease","Fructose.1.6.Diphosphatase.Deficiency","Pagetoid.Reticulosis","Pre.Excitation..Mahaim.Type","Loose.Anagen.Hair.Syndrome","Hemorrhagic.Syndrome..Bovine","Vesicular.Exanthema.of.Swine","Niemann.Pick.Disease..Type.B","Steatitis","Niemann.Pick.Disease..Type.A","Trombiculiasis","Sweating.Sickness","Leukoedema..Oral","Sulfhemoglobinemia","Glycogen.Storage.Disease.Type.VII","Carbamoyl.Phosphate.Synthase.I.Deficiency.Disease","Contrecoup.Injury","Anterior.Capsular.Rupture..Ocular","Collagenous.Sprue","Glycogen.Storage.Disease.Type.VI","Sea.Blue.Histiocyte.Syndrome","Alert.Fatigue..Health.Personnel","Posterior.Cervical.Sympathetic.Syndrome","Hyperthyroxinemia..Familial.Dysalbuminemic","Coxa.Magna","Diverticulosis..Stomach","Enteritis..Transmissible..of.Turkeys","Nocturnal.Paroxysmal.Dystonia","Jacobsen.Distal.11q.Deletion.Syndrome","Hereditary.Angioedema.Type.III","Lown.Ganong.Levine.Syndrome","von.Willebrand.Disease..Type.3","Actinobacillosis","Dourine","Hemorrhagic.Fever..Omsk","Bunion..Tailor.s","Brief..Resolved..Unexplained.Event","Crisscross.Heart","Morgellons.Disease","Epidermitis..Exudative..of.Swine","Ectodermal.Dysplasia..Hypohidrotic..Autosomal.Recessive","Uveoparotid.Fever","Farber.Lipogranulomatosis","Pneumonia.of.Calves..Enzootic","Monckeberg.Medial.Calcific.Sclerosis","Antley.Bixler.Syndrome.Phenotype","Chorea.Gravidarum","Mink.Viral.Enteritis","Encephalomyelitis..Enzootic.Porcine","Mulibrey.Nanism","Hyper.IgM.Immunodeficiency.Syndrome..Type.1","Cyclodialysis.Clefts","Trilogy.of.Fallot","Lingual.Goiter","Pneumonia..Atypical.Interstitial..of.Cattle","Tubular.Sweat.Gland.Adenomas","Familial.Multiple.Lipomatosis","Corpse.Dismemberment","Silo.Filler.s.Disease","Fascioloidiasis","Ichthyosis.Bullosa.of.Siemens","Poult.Enteritis.Mortality.Syndrome","Pyelocystitis","King.s.Evil","Tay.Sachs.Disease..AB.Variant","Diffuse.Neurofibrillary.Tangles.with.Calcification","Toxascariasis","AIDS.Arteritis..Central.Nervous.System","Leukokeratosis..Hereditary.Mucosal","Hypobetalipoproteinemia..Familial..Apolipoprotein.B","Cholera.Morbus","Allesthesia","Karoshi.Death","Glycogen.Storage.Disease.Type.VIII","White.Heifer.Disease","Corneal.Dystrophy..Juvenile.Epithelial.of.Meesmann","Acanthocheilonemiasis","Hyperlysinemias","Ectodermal.Dysplasia.3..Anhidrotic"
"Acute Myeloid Leukemia",1677,148,201,5686,134,1399,387,107,183,866,311,483,54,201,171,228,13811,117,168,375,589,114,388,96,43,111,696,308,378,121,1647,3820,239,45,166,459,264,78,1227,39,3686,2088,251,29,150,287,53,39,639,181,45,78,51,181,29,151,148,173,902,29,507,81,784,52,1097,142,210,78,49,180,95,66,82,1654,177,298,20,395,14,442,89654,249,63,18,258,67,2476,77,14,177,126,232,32,664,289,110,117,58,12,26,104,91,241,27,101,14,765,162,22,49,118,60,33,85,10,46,69,86,19,30,61,7,23,193,32,157,602,73,83,109,15,405,2585,85,14727,223,85,47,89654,19,11,125,52,129,214,31,27,60,4,436,3303,64,1595,452,225,48,92,137,215,134,9,91,46,6,32,180,325,135,29,217,469,12,128,86,8,97,307,132,81,30,41,177,2559,14,45,96,30,19,8,57,221,186,41,31,43,47,112,4,60,147,8,9,7,4,19,44,68,160,7,124,1,79,131,979,43,1574,92,18,28,36,56,41,10,148,34,43,115,163,14,38,10,1830,46,4,33,102,20,57,5,188,100,5,10,101,3,53,61,32,1786,44,45,126,421,4,71,148,202,133,129,133,20,21,59,114,20,8,1605,1299,1441,6,274,82,19,76,6,1,43,24,6,59,362,18,30,109,23,12,5263,7,6,3,26,1,39,56,5,36,36,10,6,55,34,51,15,19,6,18,843,6,18,5,53,13,223,13,59,49,24,27,60,8,28,1,149,376,12,3387,7,4,6,9,14,17,56,2,6,7,15,46,4,4669,91,425,42,2,27,7,15,211,16,46,9,4,40,52,15,3,16,30,8,10,30,45,4350,8,4,199,6,62,0,2,5,121,11,6,10,54,21,15,77,5,32,106,48,5,34,9,6597,1,5,4,48,42,8,7,12,11,4,35,8,19,11,154,46,8,200,13,26,22,504,28,18,52,25,39,117,184,7,2,5,8,455,20,19,34,6,19,24,5,79,40,7,7,9,51,12,152,2,14,5,74,2751,19,10,73,2,14,17,3,10,5,26,50,34,105,1,3,10,10,5,23,42,4,2,6,7,1427,321,13,25,26,16,32,23,6,8,111,26,67,5,82,1,41,20,1328,3,3,5,36,60,1,66,6,5,29,266,6,7,54,13,43,8,5,96,2,14,15,16,10,13,8,47,5,45,37,1,82,11,267,3,9,4,14,35,120,27,1748,12,11,2,2,4,256,16,29,19,12,23,23,8,242,16,210,312,4,21,54,827,12,4,22,6,9,8,6,1032,5,23,5,35,8,9,65,5,34,3,1162,27,18,45,572,1,7,96,80,5,7,1,14,20,9,77,2,48,26,47,1,12,0,4,25,536,37,3,24,76,5,3652,21,8,26,8,1,90,2,61,1,150,21,27,1,838,44,5,19,6,61,1,10,6,112,8,5,158,24,1,15,2,3,1,129,32,1,20,2,2,27,6,33,38,11,28,2,2,1190,36,47,5,2,3,9,1,7,5,6,2,7,4,4,5,5,11,4,34,14,38,1,11,24,65,23,69,9,15,4,56,8,9,1,14,10,11,16,6,854,17,17,22,55,68,17,14,39,15,0,14,1,20,4,0,31,14,12,28,2,6,1,13,1,4,4,14,1,9,10,3,35,9,1,5,12,23,36,2,0,619,22,7,10,1,15,53,11,2,13,9,51,25,73,5,24,9,15,35,25,12,3,11,3,10,17,8,1,6,2,1,5,4,8,5,867,30,217,9,101,22,23,96,1,2,23,74,6,4,26,95,8,0,12,10,4,2,125,1,37,11,4,5,6,5,65,4,10,39,13,8,7,0,0,8,3,59,13,3,26,14,2,3,2,1,66,14,1,9,5,4,2,4,7,3,21,2,5,14,21,1,13,4,5,0,29,1,1,6,0,9,145,2,59,0,10,98,3,2,527,0,2,6,1,1,9,3,25,3,1,2,49,3,23,4,2,6,160,32,3,185,6,4,4,8,15,9,35,6,3,3,36,59,10,8,3,4,5,507,12,7,2,16,11,0,12,23,44,3,21,188,8,20,43,129,27,7,15,13,3,2,11,69,25,23,7,12,0,1,0,15,45,2,9,15,72,0,1,66,1,13,3,115,1,52,48,3,36,67,3,2,0,10,0,5,10,2,358,10,0,0,89,21,0,240,7,1,2,14,1,20,0,90,0,5,6,7,2,10109,4,9,5,2,0,18,6,5,4,7,23,5,30,48,88,2,0,2,24,0,6,1,9,16,0,4,0,4,28,1,3,27,7,33,1,32,72,35,0,113,15,0,19,7,3,5,2,18,1375,3,0,0,17,3,8,7,2,0,5,0,3,1,2,58,37,8,3,1,13,160,3,5,39,1,117,1,3,1,3,0,19,4,66,10,19,66,6,1,3,7,3,2,0,470,1,35,5,6,1,10,6,1,7,1,1,11,34,3,6,4,1,6,1,7,0,4,2,10,3,2,32,1,0,3,0,2,2,15,106,7,2,5,1,5,4,9,33,4,20,11,1,0,8,2,0,1,3,0,2,0,17,5,0,16,3,33,9,0,726,630,229,5,1,64,14,5,0,34,28,0,33,1,5,8,0,23,1,0,13,3,2,1,1,2,1,99,1,0,9,10,8,2,1,1,470,4,7,3,4,1,1,2,1,57,7,50,1,2,1,4,4,0,2,9,746,6,0,0,0,12,148,0,8,51,0,5,0,0,10,11,0,7,2,0,3,0,0,0,11,118,7,29,0,2,5,1,0,8,26,1,3,0,7,2,253,1,19,0,4,24,1,8,45,26,55,3,6,4,5,1476,4,52,7,11,802,0,1,3,0,4,4,114,452,20,2,2,1,4,24,0,15,12,2,4,13,0,29,2,1,8,18,14,2,0,34,3,692,0,7,1,0,7,1,0,2,15,7,0,7,5,0,3,1,1,25,14,5,33,0,4,27,6,0,0,0,1,1,64,18,2,3,3,44,2,1,6,6,8,4,2,8,3,5,1,1,1,5,0,4,32,10,0,1,4,7,2,13,7,11,3,2,11,97,2,2,30,0,12,25,97,35,3,2,1,7,2,7,1,0,0,1,2,7,608,3,0,1,0,4,7,0,1,38,2,3,3,2,12,29,1,1,0,4,3,8,8,1,2,1,6,937,7,1,0,3,118,0,1,1,5,1,22,61,0,12,27,2,0,1,0,2,2,2,6,139,40,3,15,73,4,8,19,0,3,0,1885,1,4,23,0,10,10,4,6,206,0,9,6,1,11,0,0,1,5,1,10,4,0,22,1,2,0,7,46,0,17,1023,1,3,0,19,0,13,1,91,0,3,3,2,0,5,5,6,91,939,3,88,18,0,0,11,2,1,2,6,0,8,1,4,1,7,2,2,279,0,4,3,15,0,214,2,0,1,4,1,12,1,1,5968,5,0,10,2,901,29,3,1,3,2,3,0,3,59,1,2,176,13,4,0,93,20,1,2,10,3,6,10,3,1,3,0,1,0,2,0,9,43,1,1,6,0,6,11,3,1,4,3,12,0,0,3,51,643,2,1,0,1,0,0,1,2,4,0,2,3,3,0,5,0,44,32,2,2,0,90,2,3,2,0,19,203,78,4,0,1,0,246,4,1,8,0,0,2,1,0,0,13,1,8,0,1,5,4,2,0,0,58,11,0,0,1,0,19,1,0,1,4,1,0,1,11,0,7,4,1,2,1,4,14,2,2,406,7,27,0,1,1,0,0,7,0,0,2,3,0,0,10,4,0,10,0,0,3,0,5,3,0,3,0,9,2,2,5,0,3,2,7,5,1,6,3,9,5,48,0,2,3,0,1,0,1,4354,1,2,1831,7,26,8,0,1,5,1,22,4,3,0,4,0,5,19,7,2,7,4,1,0,0,0,0,22,11,0,7,22,3,1,43,0,1,9,3,0,29,1,0,8,4,6,5,15,1,2,2,1,1,2,1,1,44,0,0,7,5,2,3,2,1,9,18,0,10,1,130,1,0,1,1,2,3,1,1,4,0,2,3,0,6,4,0,0,0,4,6,1,2,11,9,10,1,1,5,4,0,22,0,1,6,0,9,0,0,16,5,0,3,0,28,6,9,3,1,0,1,1,3155,0,0,7,2,1,0,207,1,5,0,1,0,1,2,16,1,0,2,17,43,0,0,14,0,5,1,1,2,7,1,0,65,2,0,0,1,0,0,1,22,5,4,0,21,16,0,1,0,0,0,2,7,12,2,7,70,2,4,3,7,0,0,0,1,20,2,21,2,4,145,3,2,0,4,37,0,11,0,3,7,1,2,0,21,0,2,0,0,0,1,0,0,0,0,6,118,0,3,1,2,55,17,2,84,1,3,1,0,4,1,27,1,2,0,18,0,6,0,11,7,3,0,1,7,1,0,2,13,9,89,0,3,2,40,1,0,3,0,2,0,6,1,3,0,0,1,2,0,0,0,0,0,0,1,1,3,0,15,2,1,6,2,0,0,50,0,1769,0,4,4,5,0,0,1,0,0,0,2,10,2,2,2,1,3,8,0,23,1,0,3,0,5,0,1,1,4,3,1,1,26,5,0,0,0,8,0,0,0,6,1,0,0,1,6,13,0,2,0,12,0,0,29,0,1,3,0,13,0,33,44,2,0,8,2,0,0,0,1,0,0,1,0,0,2,1,5,2,0,0,0,5,0,1057,0,19,15,1,0,2,4,1,0,1,0,0,16,3,6,0,0,1,5,1,0,1,4,19,7,16,1,0,1,0,0,1,7,5,37,299,0,0,1,0,0,4,1,5,0,8,48,0,0,0,15,0,858,4,3,1,0,0,12,0,3,0,0,0,0,0,0,5,0,0,8,1,27,3,5,4,2,1,19,0,2,1,1,0,17,1,0,5,3,0,2,1,1,0,1,1,0,3,1,3,0,28,14,5,0,1,2,3,1,1,0,1,0,2,10,2,0,1,375,22,3,1,2,1,0,0,0,4,2,1,5,4,2,0,0,0,3,1,0,0,1,0,6,1,0,1,0,2,1,1,3,0,18,6,42,2,0,0,1,0,1,174,1,1,1,0,1,2,0,2,0,1,0,0,0,0,0,55,1,4,29,3,0,0,0,12,3,0,0,0,0,0,0,1,0,0,0,0,28,0,6,0,3,0,1,3,3,3,0,0,0,5,0,1,1,0,3,3,0,2,0,1,1,2,2,0,0,0,2,1,1,2,5,0,3,3,68,2,202,0,0,2,1,2,12,0,0,0,1,0,0,2,0,0,0,10,13,41,148,2,1,0,0,7,0,0,5,3,0,4,2,2,7,27,0,22,3,0,1,0,0,1,2,0,63,0,0,15,0,0,1,1,5,2,1,5,0,2,0,1,0,1,1,0,2,1,6,3,2,0,0,3,0,1,0,5,0,1,0,0,0,0,5,4,0,2,21,0,0,0,0,0,14,3,1,0,0,5,68,0,1,0,1,4,0,1,2,0,3,3,1,9,0,0,0,0,16,3,3,15,0,1,0,0,0,2,7,2,2,1,0,1,2,16,1,7,7,0,0,1,2,2,4,0,0,0,2,0,0,1,5,0,9,0,0,0,1,0,10,0,0,1,26,1,0,0,139,18,0,173,1,24,1,1,0,9,4,3,0,0,3,0,5,1,17,4,1,1,706,6,0,3,2,0,0,0,0,0,10,1,3,1,0,3,0,1,2,1,5,1,15,9,8,0,0,2,1,2,0,0,1,1,0,56,0,1,0,1,0,2,5,0,0,0,0,3,0,0,0,0,4,1,0,0,0,0,0,4,7,0,0,0,1,2,16,1,12,0,1,0,0,4,1,1,0,3,5,0,0,1,0,0,0,0,1,1,0,0,0,0,5,1,0,2,3,0,0,1,1,1,3,0,1,0,2,0,0,0,0,0,0,1,0,0,0,0,0,0,0,0,0,13,2,4,0,0,5,1,0,5,0,0,1,0,0,2,2,0,0,1,9,0,0,0,0,0,0,0,0,1,1,0,0,0,1,0,1,1,51,0,3,589,0,2,0,0,22,5,0,0,0,0,0,10,1,0,2,7,0,1,0,24,0,4,0,0,9,29,4,0,1,1,4,0,0,7,7,4,0,1,0,0,6,1,0,0,0,0,0,0,1,1,1,2,7,0,68,2,2,2,0,0,9,0,1,1,2,0,1,1,0,1,0,0,0,0,0,0,4,0,0,0,6,0,0,0,1,0,4,13,1,0,1,1330,0,0,1,10,0,0,0,2,1,7,0,1,445,0,4,0,14,1,1,1,0,1,2,4,1,3,0,0,10,1,1,0,0,9,0,1,1,0,1,0,0,29,1,4,0,0,0,0,0,1,0,0,0,0,0,0,0,0,0,0,0,3,0,0,1,1,5,1,1,0,0,0,0,1,0,0,1,2,5,0,0,0,0,0,0,371,0,0,0,2,0,3,2,0,0,0,0,2,17,23,0,0,2,0,2,4,1,0,0,0,0,0,7,4,1,0,0,0,0,1,1,0,0,1,0,1,11,1,0,0,0,2,0,1,0,4,10,1,1,38,5,0,0,1,0,8,0,2,4,5,0,0,1,0,4,3,0,11,0,2,0,2,17,0,0,0,1,0,0,4,0,0,0,0,0,4,1,0,1,0,4,6,0,0,0,0,0,0,0,0,0,14,0,4,94,0,2,0,1,0,0,0,0,0,0,1,0,0,1,0,0,0,0,1,0,0,0,10,1,0,0,0,0,0,5,0,0,2,0,0,0,0,0,0,3,0,1,8,0,0,1,0,3,1,0,0,1,6,0,0,2,0,0,0,0,1,0,23,1,0,0,2,1,0,0,0,0,0,0,5,1,5,0,1,0,0,0,5,0,1,1,0,0,1,0,0,0,0,1,0,1,8,0,0,4,0,0,0,1,1,0,0,0,1,2,2,0,0,1,1,0,1,2,0,0,0,0,0,0,0,0,1,0,0,1,0,0,1,1,1,0,0,0,0,0,7,9,1,1,0,1,0,7,0,1,0,0,2,1,0,0,0,2,1,0,0,0,0,4,0,0,0,890,3,0,0,0,0,1,0,1,0,0,4,5,1,1,0,1,1,1,1,0,0,0,0,5,1,0,1,1,2,0,0,64,0,1,3,0,0,0,0,5,0,2,0,0,0,0,0,184,5,1,0,9,0,0,0,3,0,0,1,1,65,0,0,0,0,0,0,0,0,0,1,0,1,1,0,1,0,1,0,27,3,0,0,0,28,0,2,2,0,2,1,0,0,0,42,0,1,0,0,0,0,5,0,0,4,0,0,0,5,0,0,0,3,0,0,0,0,1,0,0,3,6,9,548,5,0,6,1,0,1,0,5,0,1,0,1,0,2,0,0,9,1,0,1,0,4,0,0,1,6,0,0,0,0,0,1,0,0,0,0,0,0,0,3,0,0,1,2,30,0,0,0,0,0,2,0,0,0,0,0,0,1,0,0,0,0,0,1,0,40,0,0,1,1,0,0,0,0,0,0,0,0,0,0,61,0,3,1,7,0,2,1,0,2,0,0,1,0,156,0,1,0,0,0,33,2,0,0,0,2,1,0,0,1,0,3,0,0,0,0,0,1,0,0,0,0,0,0,0,0,0,3,0,0,0,3,1,0,0,0,0,0,0,0,0,0,0,1,0,0,1,0,0,0,0,1,0,0,0,1,0,0,0,3,2,0,0,4,0,0,0,0,0,0,0,2,10,1,0,0,0,0,0,1,0,2,0,1,0,0,2,1,1,2,0,1,0,21,0,0,0,1,1,0,0,2,0,0,0,0,0,3,6,9,4,1,0,1,1,0,1,0,0,0,1,0,0,0,0,78,1,0,0,53,2,0,0,0,0,1,0,0,0,0,4,0,0,0,4,0,0,2,2,72,0,1,0,0,0,0,1,0,0,0,0,0,0,1,0,0,0,0,2,0,65,0,2,0,0,0,0,0,0,0,0,0,50,1,0,0,0,2,0,0,0,0,1,115,0,0,0,0,0,0,1,0,0,0,0,0,3,0,0,0,0,0,1,3,0,0,0,0,0,0,1,0,0,0,0,0,0,1,0,0,0,1,1,5,1,0,0,0,0,0,0,0,1,0,0,13,0,0,4,0,0,0,0,0,0,0,0,0,5,0,0,0,0,32,0,1,0,0,0,0,1,0,0,0,0,0,0,0,0,2,32,0,0,0,0,0,0,0,0,0,0,0,0,0,0,1,0,0,0,0,0,0,0,0,0,0,0,0,0,0,0,0,0,0,280,0,0,0,0,2,0,0,0,0,0,0,0,0,0,3,1,0,0,0,0,0,0,0,2,0,0,0,0,0,0,0,0,0,0,0,1,0,0,0,1,0,0,0,0,0,6,0,0,2,0,1,0,0,0,0,1,0,0,19,0,0,0,0,0,0,0,0,0,0,0,0,0,0,1,0,0,0,0,2,0,0,1,0,2,0,1,0,0,0,0,0,0,0,0,0,0,0,0,0,0,0,0,0,0,0,0,0,0,0,1,0,0,0,0,0,0,0,61,0,0,0,0,0,0,0,0,3,4,0,0,0,0,0,0,0,0,0,1,0,0,0,0,0,0,0,0,0,0,0,0,0,0,0,0,0,1,0,0,0,1,0,1,0,0,0,0,0,0,0,0,1,0,1,3,0,0,0,0,0,1,0,0,0,0,0,0,0,0,0,0,0,0,0,1,0,0,0,0,1,0,0,1,0,0,0,0,0,0,0,24,0,0,0,0,0,0,0,0,0,0,0,0,0,0,0,1,0,0,0,0,0,0,0,0,0,0,0,0,0,0,0,0,0,1,0,0,0,0,0,0,0,0,0,0,0,1,0,1,0,0,0,2,0,0,0,0,0,0,0,0,0,0,0,0,0,0,0,0,0,0,1,0,0,0,0,0,0,0,0,0,0,0,0,0,0,0,0,0,0,0,0,0,0,1,3,0,1,0,0,0,0,0,0,0,0,0,0,0,0,0,0,0,0,0,0,0,0,0,0,0,0,0,1,0,0,0,0,0,0,0,0,0,0,0,0,0,0,0,0,0,0,0,0,0,0
"Adrenocortical Cancer",307,213,1153,908,35,268,182,38,162,165,86,119,22,47,33,59,450,78,69,79,55,31,657,75,7,66,94,128,115,24,120,97,35,27,32,21,75,53,47,21,233,303,162,35,42,31,40,21,49,75,22,25,19,120,14,45,29,38,140,167,199,47,40,49,399,40,172,125,8,8,52,43,27,109,118,123,2,93,14,51,61,210,3516,52,1085,6,197,27,1,76,47,123,13,8,197,19,18,28,1,23,31,42,117,0,21,41,37,53,5,93,31,13,85,128,18,5,73,16,13,127,36,1,2,122,60,51,131,13,35,87,17,69,106,41,74,25,37,22,43,44,4,36,44,30,20,15,18,41,2,26,97,18,71,42,94,53,133,89,59,33,8,43,6,5,12,21,63,14,28,27,75,7,48,39,8,28,27,26,79,13,1,184,69,1,15,45,21,11,7,17,90,18,17,21,6,464,46,4,16,215,7,2,13,13,10,16,32,242,2,137,2,26,163,37,27,36,34,16,11,9,25,8,5,20,4,7,44,25,12,65,5,30,7,4,13,35,73,62,5,3,11,2,51,11,0,52,10,14,75,57,55,16,15,2,29,96,3,14,6,26,27,4,57,27,30,3,48,85,22,15,63,89,15,11,3,0,33,0,24,38,140,4,11,21,3,9,8,4,23,3,4,0,16,7,10,11,6,1,10,24,4,14,8,205,3,205,20,4,20,5,24,17,52,29,9,12,24,3,80,0,30,0,12,21,5,37,12,9,21,3,18,10,15,1,6,2,4,2,1,17,64,36,10,6,12,2,8,40,11,1,10,3,9,8,2,4,6,5,3,80,2,9,13,7,3,21,2,12,1,16,0,110,4,0,2,5,7,16,13,1,57,20,10,88,6,9,15,11,3,0,10,17,1,1,0,8,13,2,3,6,3,13,15,0,23,5,11,36,55,6,3,7,64,51,4,2,5,3,10,4,17,12,10,11,4,1,6,1,4,35,1,4,23,16,5,9,2,5,0,3,47,1,1,9,0,7,52,2,1,14,5,20,11,8,1,0,0,4,48,3,19,1,0,3,0,7,25,3,4,20,9,8,6,11,15,59,4,1,4,1,0,35,6,24,0,6,4,4,42,2,36,3,24,4,20,1,3,52,2,11,1,2,37,2,7,3,0,7,822,1,0,35,5,7,2,30,6,27,9,6,9,12,20,27,7,27,3,8,1,1,8,6,19,20,11,15,9,3,13,22,25,17,8,0,961,10,10,5,2489,0,1,1,5,1,52,7,13,9,1,13,22,23,0,25,6,4,4,3,4,25,4,0,75,7,3,4,2,0,1,6,1,2,0,7,24,5,8,1,2,0,11,14,0,20,10,0,6,5,8,3,2,38,26,4,0,2,26,3,8,0,15,1,2,8,1,10,3,5,1,8,17,19,4,7,1,3,1,11,0,4,47,0,82,3,0,4,1,2,38,35,12,3,5,14,39,4,6,1,9,11,1,2,1,0,1,3,2,12,2,1,1,2,11,17,7,4,2,4,53,12,10,1,11,4,37,6,4,0,9,8,341,11,8,17,9,5,86,13,5,5,15,20,31,0,25,2,1,7,0,2,6,1,7,2,0,0,4,6,4,2,3,2,4,0,6,40,4,0,1,4,3,26,0,1,11,10,2,0,1,2,8,2,4,1,5,5,1,1,1,4,2,3,6,22,1,1,26,0,2,1,10,1,63,4,1,51,0,8,3,11,2,2,2,5,3,4,291,1,0,5,7,1,0,4,10,8,2,4,3,8,1,47,0,1,4,3,2,3,7,8,1,1,15,7,88,0,1,0,1,1,17,5,1,19,3,4,0,6,2,6,1,2,1,0,1,1,1,4,1,7,14,2,9,19,2,4,2,1,0,0,0,5,0,0,1582,36,2,10,0,4,58,2,0,55,2,18,0,0,6,2,0,41,1,1,17,4,2,10,1,0,1,2,6,0,16,1,6,6,2,9,3,13,5,1,0,2,19,10,1,32,1,1,5,0,3,3,4,1,0,12,23,2,6,1,12,10,11,5,14,29,1,17,10,2,2,2,3,7,3,1,4,1,1,1,36,7,13,1,34,28,0,2,46,0,64,0,11,1,75,15,1,5,34,4,1,0,0,0,3,0,0,10,16,22,0,3,4,0,10,1,4,0,2,1,5,2,31,0,0,28,4,2,3,31,9,0,3,0,7,28,5,26,11,13,2,4,12,3,0,321,0,2,0,41,16,8,8,0,13,0,17,19,2,0,2,15,2,0,3,4,4,0,10,10,3,5,3,3,0,0,2,2,3,14,0,2,2,0,10,1,7,1,0,1129,0,0,14,8,3,1,0,2,3,0,0,5,0,3,0,1,0,0,0,1,15,9,0,7,11,0,3,0,6,1,0,0,3,0,5,15,0,0,77,7,0,0,0,10,5,7,1,7,63,0,2,0,16,0,31,3,1,5,3,27,0,15,0,0,0,0,9,11,7,2,0,1,1,1,3,1,2,1,4,1,0,4,6,0,9,0,2,4,0,16,10,2,4,2,0,3,0,7,6,11,2,0,3,1,0,0,1,16,0,5,0,0,0,0,5,0,1,12,24,1,0,0,0,1,7,2,0,5,0,2,2,0,2,6,0,0,1,0,2,5,0,0,2,29,5,0,0,1,0,65,269,0,10,3,6,1,0,0,7,0,2,2,7,0,3,1,0,6,6,0,2,3,0,42,1,1,1,1,3,2,4,7,2,0,0,0,46,1,3,0,0,2,0,6,1,4,0,1,4,3,2,6,22,13,1,0,2,9,3,0,37,1,188,8,0,4,0,0,0,4,0,5,0,0,14,2,0,6,0,6,17,0,2,6,2,5,2,2,2,0,1,18,1,13,1,4,4,0,1,0,4,0,1,2,3,4,1,2,1,0,0,1,0,55,4,2,19,9,3,1,20,2,0,0,3,0,3,29,3,10,0,12,0,0,0,9,6,0,1,2,5,5,0,0,0,2,1,0,2,0,0,14,0,5,0,7,5,7,1,3,5,9,0,1,5,1,1,8,14,0,4,10,0,6,3,1,0,0,0,0,1,3,0,0,0,0,0,2,102,139,7,5,0,3,1,0,1,16,0,0,1,1,0,12,2,106,1,0,5,5,7,2,1,2,5,3,1,0,2,0,2,3,0,2,6,1,0,0,1,0,0,0,1,1,4,12,8,4,0,1,2,1,2,0,1,5,0,3,0,7,4,1,0,5,0,0,11,0,1,1,0,2,4,0,2,0,0,26,1,322,0,3,2,0,1,3,0,0,0,2,3,0,8,11,0,2,1,0,1,3,3,2,5,5,0,6,4,0,0,10,0,2,1,2,0,5,1,2,33,2,2,0,2,3,6,0,6,0,0,1,0,0,2,1,2,0,0,3,5,0,0,0,0,1,0,0,0,0,0,0,0,4,0,1,8,0,0,0,4,13,0,0,2,0,2,2,0,3,1,1,0,0,3,0,2,5,7,0,0,0,3,0,0,3,0,4,0,0,0,68,14,1,0,4,0,0,1,0,0,0,3,0,0,0,6,0,1,0,12,0,1,0,0,8,0,0,2,0,3,5,5,23,59,1,0,8,0,0,1,0,0,1,0,0,0,2,0,5,6,0,80,1,10,2,0,1,12,2,4,4,0,2,0,1,2,0,0,0,0,2,0,2,3,0,0,0,0,4,0,0,3,5,9,0,0,1,0,0,2,0,0,2,0,4,0,2,1,27,5,1,0,5,0,0,4,0,1,0,2,2,18,0,0,12,1,2,3,2,5,0,0,2,16,0,0,3,1,0,0,2,1,0,3,0,0,6,1,0,0,2,1,6,9,0,0,1,0,0,9,1,8,1,5,0,0,0,1,0,6,4,0,0,4,1,27,10,1,0,1,1,0,2,1,0,1,1,1,0,11,0,7,1,0,0,1,0,1,2,0,0,2,38,1,6,5,2,1,3609,6,6,0,1,4,0,0,2,1,1,1,0,11,0,1,1,0,2,0,0,1,0,1,0,0,0,0,3,8,0,0,0,4,0,6,0,0,0,0,3,1,0,14,2,0,0,1,27,3,2,1,0,0,0,0,0,0,0,0,0,0,0,3,0,1,0,0,1,0,0,0,1,3,0,2,0,0,2,1,0,1,0,1,11,3,0,0,10,0,0,0,0,0,2,0,1,1,74,0,0,3,1,0,0,0,0,4,1,3,2,1,0,3,3,1,32,0,0,2,1,19,3,11,0,2,7,0,0,0,0,1,0,1,0,0,0,0,9,0,2,0,2,0,0,0,0,0,0,0,0,1,1,0,52,0,1,3,2,1,19,0,1,0,8,4,5,0,0,23,2,3,2,4,0,21,1,0,0,0,12,5,11,0,0,1,0,0,5,2,2,2,0,0,0,0,1,0,5,2,0,1,1,1,1,2,0,0,91,1,0,0,0,0,2,0,0,0,2,0,1,0,0,13,0,0,1,0,0,1,0,0,2,1,2,2,0,11,1,1,2,0,0,1,0,6,2,0,23,0,0,0,0,1,0,0,3,2,0,2,2463,0,0,0,1,1,2,0,0,0,57,3,1,0,0,0,0,0,0,0,0,1,1,6,0,0,0,1,0,4,1,0,1,0,0,0,0,0,0,0,0,1,8,2,0,1,0,0,1,1,0,7,5,1,0,0,1,0,2,0,1,0,2,1,1,0,0,0,1,2,0,0,14,1,5,0,0,0,1,4,0,0,0,0,4,2,0,0,1,0,0,34,0,1,3,2,10,0,4,0,0,0,3,1,2,0,0,2,2,0,1,1,0,0,0,0,0,1,0,0,3,1,8,0,8,7,1,2,0,0,0,0,0,1,0,1,1,5,66,3,0,4,1,0,0,1,0,0,0,0,0,0,0,12,0,0,15,0,0,1,0,1,0,29,5,0,0,0,3,0,0,22,0,0,0,0,0,1,1,4,6,6,2,0,9,2,0,0,3,1,0,0,3,0,3,5,1,0,0,0,5,3,2,0,0,0,0,0,4,0,0,14,0,0,2,0,0,0,0,0,0,0,0,0,0,0,0,15,1,0,3,0,0,2,0,1,2,2,0,0,0,0,2,0,0,0,9,0,6,0,0,0,0,2,0,0,0,1,1,1,0,0,0,0,0,0,1,0,0,0,0,0,1,0,2,0,1,0,0,0,1,0,3,88,3,1,0,0,0,0,1,0,0,1,0,0,0,0,4,0,0,0,0,0,0,4,1,1,1,0,0,0,0,1,2,0,2,0,0,1,0,0,0,0,3,16,1,1,1,0,0,1,2,0,3,0,0,4,0,0,0,0,1,1,4,0,2,4,0,0,0,0,0,0,2,0,2,2,0,0,0,0,0,0,0,1,0,0,0,0,0,8,8,0,0,0,0,0,0,1,0,0,1,1,15,0,0,19,4,0,0,1,6,8,0,0,2,2,1,0,1,1,2,0,0,2,1,0,0,1,1,1,1,0,0,2,2,2,0,2,0,0,7,2,0,6,0,1,0,0,0,1,1,0,0,0,0,0,1,51,1,0,1,0,0,0,1,0,16,0,1,125,1,0,1,0,0,1,0,6,19,1,0,1,0,0,0,4,0,0,1,1,20,0,3,0,0,6,1,0,0,1,2,0,0,1,0,3,9,0,1,0,0,0,0,0,0,0,1,2,0,2,0,0,3,0,1,0,0,0,2,0,0,0,0,0,0,5,0,1,2,1,0,0,0,3,0,0,0,0,3,2,1,0,0,0,0,69,1,0,7,0,1,0,0,0,0,2,23,3,1,0,3,0,0,1,3,0,0,0,0,0,0,0,1,2,0,0,2,0,0,0,0,1,1,6,0,2,0,0,0,0,0,0,0,0,0,0,1,0,1,2,10,0,0,0,0,0,0,0,0,4,2,1,2,0,5,44,0,0,0,0,0,0,0,6,0,0,0,1,0,0,0,0,0,2,0,0,0,0,1,0,0,1,0,0,1,0,3,0,10,1,1,4,0,0,1,5,0,0,0,0,0,1,7,0,0,0,1,1,4,170,0,0,2,0,0,0,4,0,2,0,0,0,1,4,0,7,0,13,0,0,1,1,1,0,0,0,0,1,0,0,0,0,0,0,0,4,0,2,0,0,0,0,0,3,0,4,1,0,0,0,2,0,0,0,0,0,2,0,0,1,2,0,1,0,0,0,0,1,2,0,0,0,0,0,0,1,0,0,0,1,2,3,0,2,2,1,0,0,3,0,5,0,1,0,1,2,0,4,13,0,15,1,1,0,0,3,1,0,0,0,0,0,0,1,0,0,0,0,0,0,0,0,0,0,0,0,0,0,1,0,1,0,0,1,0,0,0,1,0,2,0,0,0,0,1,0,0,0,0,1,0,0,0,0,0,0,0,0,0,1,0,1,0,0,0,0,0,0,0,1,0,0,0,0,0,0,0,0,0,0,0,0,0,0,0,5,2,0,0,0,0,2,1,1,1,0,0,0,0,0,0,0,0,0,88,0,0,0,0,0,13,4,1,0,0,0,0,1,0,0,1,0,0,0,0,3,1,3,0,1,1,0,1,1,0,2,0,0,4,0,0,1,0,0,0,9,0,0,0,0,0,0,0,5,0,0,0,0,0,0,0,0,0,0,8,3,0,1,143,0,0,1,1,0,0,0,0,0,0,0,0,0,0,0,0,0,0,0,0,0,0,0,0,6,0,1,0,0,0,0,1,0,0,0,0,0,0,0,0,0,0,0,2,0,0,1,1,0,0,3,0,0,0,0,0,0,0,0,0,2,0,0,0,0,0,13,0,0,0,0,0,0,0,0,0,0,0,0,1,1,0,0,1,0,3,0,0,1,0,0,0,0,0,0,0,2,3,0,0,0,0,0,1,0,1,0,1,0,0,3,0,0,1,1,0,0,0,1,4,0,0,0,0,0,0,0,0,0,0,0,3,0,0,0,0,1,0,7,1,0,2,0,2,0,0,0,0,0,1,1,0,0,0,1,0,0,0,0,0,0,1,0,0,0,0,17,0,0,0,0,0,1,0,3,0,0,0,0,0,0,0,0,0,0,0,3,0,0,1,0,0,0,0,0,0,0,0,7,0,0,0,0,0,0,0,1,0,0,1,0,0,0,1,0,2,0,0,0,1,0,0,0,0,0,0,1,0,0,0,0,0,0,0,0,0,0,3,0,0,0,0,0,0,0,0,0,6,0,0,0,2,0,0,0,2,0,0,0,0,0,0,0,1,0,0,0,1,0,1,0,0,0,2,0,7,0,0,1,0,0,7,1,0,0,0,0,0,0,0,0,0,0,2,0,1,0,0,0,1,0,1,0,0,2,1,0,0,0,0,8,2,0,0,0,0,0,0,0,0,0,0,7,13,0,0,0,1,0,0,0,0,0,1,1,0,0,0,0,0,0,0,0,0,1,0,0,5,0,0,0,0,0,0,0,0,0,0,0,0,0,0,0,0,2,0,0,0,0,0,0,1,0,0,0,0,0,0,0,1,0,0,1,0,0,0,0,0,0,0,3,0,0,0,1,0,1,0,0,0,0,3,0,0,0,6,0,1,1,0,0,0,1,0,0,0,0,0,0,1,0,0,0,0,0,0,0,0,1,0,0,0,0,0,0,1,0,0,0,0,0,0,2,0,2,2,0,0,0,0,2,0,0,0,0,2,1,0,0,0,0,0,0,0,0,0,0,0,0,0,2,0,1,0,0,0,0,0,0,0,0,0,3,0,0,0,0,0,0,0,0,0,0,0,0,1,0,0,0,0,2,0,0,1,3,0,0,0,1,0,0,0,0,0,0,2,0,0,0,1,0,1,0,0,0,0,0,0,2,2,0,0,0,0,0,0,0,0,0,0,0,0,0,0,0,0,0,0,0,0,0,0,0,0,0,7,0,0,0,0,1,0,0,0,0,1,0,0,0,0,1,0,1,1,0,0,0,5,0,0,0,0,0,1,0,0,0,0,0,0,0,0,0,0,0,2,0,0,0,0,0,0,0,1,0,0,0,0,0,0,0,0,1,0,0,0,1,0,0,1,0,0,0,1,0,0,1,0,3,0,0,0,1,0,0,1,0,0,0,0,0,0,0,0,0,0,0,0,2,0,0,0,0,0,0,0,0,0,0,0,0,0,0,0,0,0,0,0,0,0,0,1,2,0,0,0,0,0,0,0,1,1,0,45,0,0,0,0,0,0,0,0,0,0,0,0,0,0,0,1,0,0,0,0,4,0,0,0,0,0,0,0,0,0,0,0,0,0,0,1,0,2,0,0,0,0,0,0,0,0,0,0,0,0,7,0,0,0,0,0,0,0,0,1,0,0,0,0,0,0,1,1,0,0,0,0,0,0,0,0,0,0,0,0,0,0,0,0,0,0,0,0,0,0,0,0,0,0,0,0,1,2,0,2,0,0,0,0,0,0,3,0,0,0,0,0,0,0,0,0,0,0,0,0,0,0,0,0,0,1,0,1,0,0,0,0,0,0,0,0,0,0,0,0,0,0,0,0,0,0,0,0,1,0,0,1,0,0,0,0,0,0,0,0,0,0,0,0,0,0,0,0,1,0,0,0,0,0,0,0,0,0,0,0,0,0,0,0,0,0,0,0,0,0,0,0,0,0,2,0,0,0,0,0,0,0,0,0,0,0,0,0,0,0,0,1,0,0,0,0,0,0,0,0,0,0,1,0,0,1,0,0,1,0,0,0,0,0,5,0,0,0,0,0,0,0,0,0,0,0,0,0,0,1,0,0,0,1,0,0,0,0,0,0,0,0,0,0,9,0,0,0,0,0,0,0,0,0,0,0,1,0,0,0,0,0,0,0,0,0,0,0,0,0,0,1,0,0,0,0,0,0,0,0,0,0,0,0,0,0,0,0,0,0,0,0,0,0,0,1,0,0,0,0,0,0,0,0,0,0,0,0,0,0,0,0,0,0,0,0,0,0,0,0,0,0,0,0,0,0,0,0,0,0,0,0,0,0,0,0,0,0,0,0,0,0,0,0,0,0,0,0,0,0,0,0,0,0,0,0
"Bile Duct Cancer",547,182,220,2948,37,657,40,14,116,67,18,1396,17,86,12,29,420,55,49,1034,99,29,2622,46,5,10,289,268,221,7,341,164,114,3,8,123,45,9,244,11,1118,476,75,28,84,57,7,3,90,207,5,19,7,331,75,10,363,59,124,876,170,115,64,27,1181,155,3506,214,7,44,1347,11,17,24,16,176,0,136,478,115,68,309,3104,218,519,2,190,17,1,26,16,107,665,1,29,6,16,1,1,146,428,67,760,29,4,24,131,9,8,1314,367,5,9,36,27,1,28,241,168,13,10,2,1,74,9,81,1262,13,29,174,57,190,133,31,15,418,15,9,27,113,11,22,19,56,196,131,9,47,1,26,271,4,83,31,13,17,39,42,704,9,0,6,0,0,3,7,205,28,7,18,181,5,10,1634,12,2,22,18,19,3,0,468,104,15,6,54,0,7,2,6,23,6,4,4,0,19,14,13,3,45,1,0,748,6,0,14,38,111,1,157,109,1,275,24,7,28,175,1,66,6,196,13,3,6,4,9,24,74,98,160,59,61,10,3,0,9,18,449,1,10,1,0,317,6,2,92,5,2,18,4,6,6,31,3,29,20,7,26,9,13,38,1,4,197,239,0,55,76,23,19,12,8,6,4,1,1,41,0,0,6,16,8,2,3481,0,0,22,2,0,0,0,0,699,13,4,126,4,0,22,1,1,3425,10,299,2,300,7,6,184,5,2,0,22,2,67,7,1,2,827,0,6,6,36,8,7,17,1716,5,0,0,62,18,21,1,1,1,0,0,0,14,92,34,5,12,22,2,5,9,4,6,1,1,2,1,19,15,156,7,0,6,1,1,2,0,590,52,1,7,0,0,0,182,70,7,0,0,2,2,6,47,19,100,190,10,1,0,2,29,0,8,1,21,0,0,2,27,98,0,20,34,356,1113,1,1,16,1,2,7,68,1,2,1,9,25,19,3,1,14,4,0,13,7,12,5,1,0,3,36,0,5,0,56,0,2,3,0,1,3,2,64,12,0,1,4,2,70,0,15,0,0,3,6,39,28,0,0,0,1,20,1,48,2,0,1,0,8,53,1,0,5,10,33,3,4,118,8,2,13,12,5,0,169,2,18,0,0,6,1,4,0,39,12,13,1,91,0,3,9,2,4,6,0,9,0,79,0,3,0,61,0,2,32,7,3,0,3,5,15,3,5,2,3,6,7,4,198,1,5,1,1,0,10,213,27,1,2,13,8,6,21,38,76,11,0,21,3,8,2,4,11,1,4,0,0,17,69,567,2,5,34,5,2,3,6,0,10,6,2,0,2,4,1,46,30,1,0,3,0,4,0,1,1,5,2,0,0,17,0,0,0,30,1,75,5,1,0,2,6,5,8,0,0,33,5,1,1,5,2,571,0,5,3,0,3,0,5,17,2,0,1,34,2397,40,78,0,1,0,2,0,18,652,0,328,83,829,3,1,0,1,2,67,0,1,7,25,226,0,0,6,10,0,0,1,1,0,77,1,5,2,1,1,0,1,0,7,5,0,1,5,32,1,0,1,1,11715,0,6,0,22,4,4,1,77,31,201,4,0,22,9,1,9,95,23,0,72,1,2,0,6,2,18,1,3,0,0,0,5,0,0,1,3,0,4,0,4,12,35,0,0,112,894,3,0,0,21,1,4,0,0,0,1,8,9,0,1,4,2,1,0,10,32,1,0,8,0,1,12,0,0,1,38,4,286,0,0,14,0,1,1,3,1,2,0,7,7,30,8,0,2,8,0,0,0,0,3,7,1,1,362,5,0,78,0,0,467,0,0,0,1,21,0,2,49,2,2,1,0,0,4,22,0,6,0,2,1,13,1,3,0,2,15,0,33,0,26,0,0,543,0,1,0,0,3,3,0,0,0,0,0,3,0,331,5,0,4,92,0,1,0,0,2,0,7,21,1,0,1,0,0,0,2,9,0,690,2,307,0,9,0,0,0,2,2,26,25,0,1,0,5,3,0,75,2,1,0,14,5,0,0,6,0,0,6,28,0,0,3,0,0,1,50,1,1,12,70,56,0,32,5,6,0,1,52,0,0,0,0,4,6,0,1,0,0,5,9,8,4,0,28,0,1,0,63,1,1,4,7,0,7,12,0,1,0,0,2,0,1,0,1,0,1,8,19,183,0,2,6,0,14,0,16,1,14,0,0,0,3,0,0,129,19,1,3,130,7,0,24,0,3,0,0,2,1,2,0,1,74,6,8,0,1,0,0,1,7,17,6,0,1,1,0,3,2,0,185,0,0,0,28,0,1,0,10,1,0,0,72,61,0,0,3,0,0,20,2,1,0,0,0,0,277,3,0,0,0,0,5,8,1,0,0,0,3,4,0,2,27,37,0,0,0,0,0,0,2,1,2,1,3,6,0,0,0,0,0,1,4,1,7,4,0,0,11,2,0,7,0,0,9,1909,2,0,0,0,0,0,21,3,112,0,0,1,2,8,0,1,0,0,0,0,0,3,22,0,1,0,0,1,0,0,7,3,9,1,0,2,2,0,11,0,0,0,0,1,2,1,0,1,1,0,0,12,10,1,0,0,1,0,11,0,0,264,0,3,0,0,16,0,4,1,1,2,64,1,2,1,0,0,5,0,0,143,20,0,3,0,0,6,0,0,2,0,5,78,0,0,1,5,1,1,0,0,1,55,0,0,0,1,2,6,4,0,16,2,48,1,4,1,16,0,0,0,5,0,4,0,0,72,1,0,0,1,2,12,6,4,0,0,0,0,2,0,108,0,0,3,0,4,1,1,0,0,10,1,1,11,9,0,0,0,12,1,3,7,2,0,14,1,0,1,0,0,0,405,0,2,4,1,990,1,13,0,0,2,90,0,0,4,1,22,0,0,8,2,5,15,1,10,329,0,4,0,0,0,0,0,386,0,2,1,1,0,0,0,0,7,0,35,1,0,8,1,0,0,117,1,152,0,1,0,23,48,0,0,1,0,0,0,0,1,3,0,0,3,2,2,0,0,0,0,3,1,11,0,0,23,0,5,10,1,1,0,1,0,3,8,0,0,6,0,1,26,1,2,1,2,0,1,2,5,4,0,0,1,2,0,1,0,8,0,106,0,23,0,3,1,71,1,8,0,0,21,0,0,0,0,0,12,0,0,0,0,1,7,0,0,1,5,2,1,0,3,15,379,1,1,0,0,4,3,0,0,0,1,0,0,0,0,1,3,3,2,1,0,2,0,1,0,0,1,0,2,0,2,11,0,0,0,1,1,1,0,0,0,0,1,5,0,0,0,2,3,8,0,23,0,5,0,1,1,0,0,0,2,4,0,0,5,0,1,0,0,0,0,0,0,0,6,0,11,1,0,0,8,0,0,0,0,0,0,3,2,1,1,20,0,0,1,0,9,0,1,0,1,0,12,1,0,2,0,6,3,1,0,1,0,0,0,0,1,0,0,7,0,52,4,3,0,1,0,0,0,1,10,0,1,0,0,21,0,0,3,0,0,0,0,0,0,0,0,0,0,1,0,0,1,0,0,0,4,0,0,0,1,0,0,0,0,0,0,0,0,6,0,14,0,0,0,7,2,1,0,70,0,0,1,0,0,2,19,61,0,3,0,1,5,0,0,0,1,0,363,19,0,0,0,1,0,0,20,0,11,0,0,0,0,0,11,0,18,0,7,1,0,0,33,0,0,0,0,1,0,0,0,0,0,10,0,0,0,0,3,0,14,0,2,2,0,0,0,0,0,1,0,0,5,0,0,1,8,5,3,0,0,5,0,0,0,1,0,1,0,8,4,93,1,2,12,23,0,9,0,7,1,4,2,46,0,0,3,0,0,0,0,2,0,0,0,2,1,0,0,0,1,0,1,0,2,0,0,0,946,1,2,3,1,1,0,0,0,1,0,7,0,0,0,3,0,2,0,0,0,1,0,0,0,0,0,1,0,0,0,9,0,0,1,9,0,0,0,0,0,0,49,4,6,0,2,80,1,10,6,0,75,0,0,0,0,0,0,0,1,0,0,2,0,1,0,0,0,2,0,0,0,0,0,0,0,0,5,2,0,0,1,0,0,20,0,0,0,0,1,0,0,17,0,0,0,0,88,0,1,0,0,0,0,1,3,0,0,2,0,0,0,0,0,0,0,1,0,0,0,0,0,0,0,0,36,0,1,0,0,2,0,0,0,1,0,0,0,0,0,0,1,1,4,0,1,4,2,0,1,0,0,0,0,0,0,84,14,5,9,2,1,1,0,0,7,0,0,11,0,3,2,2,0,1,1,0,1,0,0,0,0,1,0,0,3,5,6,0,21,0,6,0,0,0,0,4,0,0,0,0,0,0,3,1,0,0,0,0,6,0,0,0,1,4,0,0,0,108,0,0,1,2,0,2,0,0,0,1,0,32,22,0,0,4,0,3,1,0,1,0,0,0,0,0,7,0,1,0,0,1,0,14,0,0,0,0,1,0,0,2,0,2,0,0,0,4,1,0,0,0,0,13,0,4,0,0,0,0,0,0,0,0,0,11,16,50,1,0,2,0,0,6,0,1,0,0,188,0,0,2,0,45,0,0,1,0,0,0,3,0,0,0,0,0,1,0,0,0,7,2,0,0,0,0,4,0,0,1,0,2,0,0,0,0,0,0,0,24,0,0,0,0,391,0,26,0,0,195,1,0,7,0,0,0,0,0,2,0,0,34,1,0,0,0,0,1,0,0,12,0,21,0,0,0,0,0,0,6,1,0,0,0,2,0,1,0,1,110,0,6,0,1,2,2,0,0,0,1,0,289,0,0,0,4,1,0,0,0,1,0,3,0,0,0,0,0,0,0,0,108,0,0,0,0,0,0,0,0,0,0,1,0,2777,0,0,1,0,0,0,0,0,0,0,0,0,1,5,0,0,0,0,0,0,1,0,0,0,0,0,0,0,125,0,0,1,0,0,1,0,0,3,4,0,1,0,0,1,0,0,1,0,2,0,0,0,0,0,4,2,4,0,0,41,0,3,0,0,0,0,0,0,66,0,13,0,0,1,0,6,0,1,0,0,21,0,0,0,0,0,3,0,0,4,0,14,0,0,3,0,0,152,0,0,0,0,0,0,0,6,0,0,0,0,1,0,0,2,0,0,0,3,0,0,0,14,0,0,0,3,0,0,0,1,0,0,3,0,0,1,2,0,5,0,0,1,0,0,1,0,0,0,0,0,0,0,0,0,0,2,0,0,5,0,0,1,0,0,0,4,0,0,0,1,0,0,0,33,0,0,3,0,0,15,1,0,1,4,2,0,0,0,11,0,0,1,3,0,2,0,0,0,0,0,3,2,1,0,0,2,1,0,0,1,0,0,0,0,0,0,0,0,1,44,0,0,0,0,0,0,2,1,0,0,0,5,0,6,0,0,4,1,0,0,0,0,0,0,0,0,1,1,2,0,0,4,0,0,0,0,1,2,1,0,0,0,9,1,0,0,0,0,0,0,0,0,34,0,0,0,0,4,0,0,2,2,0,0,0,0,0,0,0,0,2,1,3,0,0,1,0,16,0,0,28,0,13,0,0,1,0,0,0,0,30,0,0,0,1,1,0,0,0,0,1,0,1,1,0,0,6,1,1,0,1,4,1,0,1,3,1,0,0,0,0,0,1,0,0,0,0,5,0,1,0,0,0,0,0,0,0,4,0,0,0,0,0,77,0,0,1,0,0,0,0,43,0,1,0,1,1,0,0,0,0,2,0,0,0,8,3,0,0,0,5,0,0,278,0,4,0,0,0,0,0,0,0,0,0,1,0,0,0,0,0,0,0,0,0,0,0,1,0,0,11,2,0,0,0,1,0,31,0,0,0,6,0,0,0,0,0,0,0,2,0,0,146,33,0,0,0,1,0,0,0,1,0,0,0,0,23,0,0,1,0,0,0,1,0,3,79,19,0,0,0,0,1,0,0,2,0,0,3,0,0,0,1,0,0,0,0,0,0,0,0,0,0,0,0,0,0,0,0,0,0,0,0,0,0,0,0,0,0,0,0,0,0,4,0,0,1,0,0,0,0,1,0,0,0,0,0,0,0,0,0,0,0,0,0,1,1,0,15,0,0,0,0,1,1,5,0,0,0,0,0,0,7,0,4,0,0,0,0,1,32,0,0,0,0,0,0,0,0,0,0,0,0,17,0,0,0,1,0,1,3,0,4,0,0,0,0,1,0,0,0,0,0,0,3,0,1,0,0,0,0,0,1,0,0,0,0,0,0,1,0,0,0,0,0,0,0,0,0,0,0,0,0,0,0,1,0,1,0,0,0,0,0,0,4,0,0,0,0,0,0,0,4,6,0,0,0,4,0,0,0,0,0,0,0,0,0,0,0,0,0,0,0,0,0,0,0,0,0,0,0,0,0,3,0,0,0,2,0,0,0,0,0,0,0,0,0,2,0,0,0,0,0,0,0,0,0,0,0,0,0,0,0,1,0,0,0,0,2,0,0,1091,0,2,0,0,0,0,0,0,0,0,0,4,0,0,0,0,0,0,0,0,0,0,0,0,109,0,0,1,0,0,0,0,0,0,1,0,0,2,0,0,0,0,2,0,16,0,1,0,0,0,0,0,0,0,0,0,0,0,0,0,0,0,0,0,0,0,0,0,0,0,0,0,1,0,0,0,0,0,1,0,0,0,0,0,0,0,0,0,0,0,18,4,0,1,0,0,0,0,0,0,0,0,0,0,0,0,0,0,0,0,0,0,0,0,0,0,0,0,2,0,1,0,0,0,4,15,0,0,0,0,30,0,0,0,0,1,0,0,0,0,0,0,0,0,1,0,0,1,0,0,0,0,0,0,0,0,0,0,0,0,1,1,0,0,0,0,0,5,0,0,0,0,0,0,0,1,0,0,0,0,1,0,0,3,1,0,0,1,1,0,5,0,0,0,0,0,0,0,1,0,1,0,0,0,0,0,0,1,0,0,0,0,1,20,0,0,0,0,0,0,0,0,0,0,1,0,0,0,0,0,0,0,0,1,1,1,0,1,0,0,0,0,1,0,0,0,0,0,0,0,0,0,0,0,5,0,1,0,0,0,0,0,0,0,0,0,0,0,2,0,0,1,0,59,0,3,0,0,0,0,1,0,0,1,0,0,0,0,0,0,0,0,0,0,0,1,0,0,0,0,0,0,0,0,0,0,1,0,0,0,0,0,0,0,39,0,0,0,0,0,3,0,0,0,0,0,0,0,0,53,0,2,0,0,0,0,1,0,0,0,0,0,0,0,0,6,0,0,0,0,0,0,0,0,0,0,2,2,0,0,0,0,0,0,0,0,0,0,0,0,0,0,1,0,0,2,0,0,0,0,0,0,5,0,0,0,0,0,0,0,0,0,0,0,0,0,0,0,0,1,0,1,0,0,0,0,0,0,0,0,0,0,1,0,0,0,0,0,0,0,0,0,0,0,0,0,0,0,0,0,0,0,0,0,0,0,0,0,0,0,0,3,0,0,0,0,1,0,0,0,0,0,0,0,0,0,1,0,0,0,0,0,0,1,0,0,0,0,1,0,0,0,0,8,0,0,1,0,0,0,0,0,0,0,6,2,1,0,0,1,0,0,0,0,0,0,0,0,3,2,0,0,0,4,0,0,2,0,0,0,0,1,0,0,0,0,0,0,2,0,0,0,0,0,0,0,0,1,0,0,0,0,0,0,0,0,2,0,2,0,0,0,0,0,0,0,0,0,0,3,0,0,1,0,0,0,0,0,0,0,2,2,17,0,0,0,0,0,0,0,0,0,0,0,0,0,0,0,0,0,1,0,2,0,0,0,0,0,0,0,0,0,0,0,4,0,0,0,0,0,0,46,0,0,0,0,0,0,0,0,0,0,1,0,0,0,0,0,0,1,0,0,0,0,0,0,0,0,0,0,0,0,0,0,0,0,0,2,0,0,2,13,0,0,0,0,0,0,0,1,0,0,0,0,0,0,0,0,0,0,0,0,0,1,0,0,1,2,0,0,0,0,0,0,0,0,0,0,0,0,0,0,0,0,0,2,0,1,0,0,0,0,0,0,1,0,2,0,0,0,0,0,0,0,0,0,0,0,0,0,18,0,0,0,0,0,0,0,0,0,0,0,0,0,0,0,1,0,0,0,0,0,0,0,0,0,0,44,0,0,0,0,0,0,0,0,0,0,0,2,0,1,0,0,0,0,0,0,0,0,0,0,0,0,0,0,0,0,0,0,0,0,0,0,0,0,0,1,0,0,0,0,0,0,0,0,0,0,0,0,0,0,0,0,1,0,0,0,1,1,0,0,0,0,0,0,0,0,0,0,0,0,0,0,0,0,0,0,0,0,0,0,0,0,0,0,0,0,0,0,0,1,0,0,0,0,0,0,0,0,0,0,0,0,0,0,0,0,0,0,0,0,0,158,0,0,0,0,0,0,0,0,0,0,0,0,0,0,0,0,0,0,0,0,0,1,0,0,0,0,0,0,0,0,0,0,0,0,0,0,0,1,0,0,0,0,0,0,0,0,0,0,4,0,0,0,0,0,0,0,0,0,0,0,1,0,0,0,0,0,0,0,0,0,0,0,0,0,1,0,0,0,0,0,0,0,0,0,0,0,0,0,0,0,0,0,0,0,1,0,0,0,0,0,0,0,0,0,0,0,0,0,0,0,0,0,0,0,0,0,0,1,0,0,0,0,0,0,0,0,0,0,0,0,0,0,0,0,0,0,0,0,0,0,0,1,0,0,0,0,0,0,0,0,0,0,0,0,0,0,0,0,0,0,0,0,0,0,0,0,0,0,0,0,0,0,0,0,0,0,0,0,0,0,0,0,0,0,0,0,0,0,0,0,0,0,0,0,0,0,0,0,0,0,0,0,0,0,0,0,0,0,0,0,0,0,0,0,0,0,0,0,0,0,0,0,0,0,0,0,0,0,0,0,0,0,0,0,0,0,0,0,0,0,0,0,0,0,0,0,2,0,0,0,0,0,0,0,0,0,0,0,0,0,0,0,0,0,0,0,0,0,0,0,0,1,0,0,0,0,0,0,0,0,1,0,0,0,0,0,0,0,0,0,0,0,0,0,0,0,0,0,0,0
"Bladder Cancer",1269,645,577,14468,174,2492,276,161,422,302,285,473,159,220,207,155,2069,225,705,271,378,161,5972,171,62,57,265,607,297,39,529,498,288,201,134,199,538,91,361,66,4121,2441,299,255,199,350,34,13,239,195,35,23,64,309,168,109,43,116,1016,456,1962,282,121,92,7373,230,603,175,27,84,121,45,276,50,142,310,22,299,645,382,304,2483,917,423,2156,39,755,247,17,127,158,674,1256,15,441,28,91,133,29,338,70,212,517,28,90,57,220,117,26,2317,54,11,58,99,313,29,91,55,56,133,111,28,21,764,120,128,6323,31,63,147,35,341,433,104,155,325,161,29,193,62,34,159,306,117,181,227,21,181,17,35,1016,37,325,113,136,70,301,507,148,31,10,57,16,15,16,10,1014,60,44,186,398,11,44,67,119,19,97,85,94,11,7,1586,497,8,12,126,73,15,14,111,110,21,20,72,12,53,59,64,42,137,4,3,861,25,13,61,167,3068,6,781,48,37,9374,180,73,402,101,8,25,27,365,17,8,18,19,28,33,443,162,69,106,527,211,7,74,29,41,4350,20,10,31,1,942,77,10,281,25,18,87,26,83,12,46,11,100,230,12,135,19,76,112,7,29,153,347,1893,274,312,314,16,63,127,15,16,5,4,75,7,6,289,224,56,12,93,13,4,81,5,5,14,5,3,166,28,787,121,93,29,53,49,17,19,38,243,10,251,24,7,151,15,27,33,321,15,437,31,10,9,2858,3,75,22,51,28,32,110,123,818,5,7,38,82,78,6,11,10,6,6,1,113,118,91,29,140,101,2,23,25,14,5,14,4,6,6,16,15,30,98,3,12,14,9,36,5,164,76,6,104,1,1,5,1405,11,166,14,54,19,8,21,12,24,25,18,29,97,8,24,56,406,83,24,172,2,7,1,57,21,5,299,30,403,29,17,4,63,2,19,52,208,13,8,3,14,548,24,6,4,13,442,5,33,60,14,87,20,4,58,12,4,57,0,64,1250,15,27,2,14,10,2,19,13,1,4,15,16,10,18,743,2,5,14,3998,93,97,5,0,1,5,71,8,136,18,6,426,7,188,292,4,1,13,10,38,58,22,83,36,15,52,28,6,3,26,6,81,3,2,47,115,52,3,225,14,23,27,126,2,6,51,15,7,14,2,106,3,1,3,3,0,601,6,5,500,101,20,6,9,12,35,308,11,185,18,31,23,3,714,4,29,2,9,8,18,1464,176,15,9,34,12,204,365,18136,27,87,3,425,96,28,20,8,4,1,7,8,1,112,402,18,19,25,79,32,8,200,41,18,45,5,12,62,7,24,5,110,43,4,7,274,0,5,4,18,0,7,25,11,8,60,7,1,5,28,19,13,14,12,3,17,19,28,5,10,6,132,3,9,16,10,15,98,1,49,5,1,7,3,145,12,6,1,14,129,30,75,119,7,13,0,28,1,10,444,1,408,11,50,6,4,6,26,28,107,15,27,22,255,93,9,6,361,62,13,14,1,1,3,458,2,3,10,0,4,59,13,16,23,90,0,4,114,78,15,1,10,3,195,13,794,1,45,15,19,40,60,91,49,14,7,126,23,5,103,169,43,1,48,12,13,3,10,55,1061,14,6,2,3,2,18,3,3,2,9,3,945,2,7,101,82,2,2,25,4,31,13,331,37,11,15,2,2,1,9,28,35,62,27,31,21,3,1,45,15,14,5,45,21,0,19,2,5,4,57,13,129,6,3,87,1,14,4,24,2,46,4,2064,17,287,25,37,88,31,3,5,1,0,15,4,78,10,444,165,8,680,30,1,15,2,2,3,6,84,1,1,348,5,6,0,0,2,5,6,6,3,2,9,6,4,4,14,3,19,4,1,19,2,3,5,3,54,4,12,4,5,10,6,2,83,20,2,0,14,2,48,11,7,6,194,935,11,1,1,25,0,3,168,0,4,6,1,0,1,114,38,5,32,8,31,8,98,1,1,1,39,24,16,40,5,9,5,3,28,5,120,1,16,0,32,21,3,3,11,1,4,36,11,8,1,1,0,0,6,375,2,16,16,22,66,32,67,11,77,2,43,8,3,3,5,5,17,10,2,4,7,1,26,39,6,10,1,38,4,0,0,226,1,6,7,16,0,59,156,3,12,10,0,23,1,10,0,3,7,3,84,17,283,0,10,29,1,132,0,26,0,51,52,4,3,10,1,3,50,5,3,36,32,85,0,57,1,4,4,2,15,3,9,4,8,109,46,29,1,3,1,2,5,23,56,16,0,12,2,3,16,1119,2,33,5,8,0,5,3,10,1,76,12,2,6,23,5,3,0,20,22,2,59,0,47,8,4,20,2,15,3,9,1,0,765,19,7,2,1,4,6,2,5,0,23,35,65,0,3,0,144,1,6,6,37,3,7,5,1,5,4,3,22,1,0,11,14,71,4,3,0,36,6,1,3,1,0,23,29,4,27,24,1,0,0,33,8,27,1,3,6,4,105,198,7,5,0,2,5,4,59,60,0,3,6,5,10,6,6,104,8,3,0,0,1,4,0,8,1,0,2,0,39,26,62,7,5,6,6,1,25,84,1,1,0,0,1,1,3,0,83,2,3,0,2,1,3,8,0,2,6,71,1,34,1,4,3,19,8,0,248,4,8,8,0,40,22,0,5,1,2,3,6,0,0,2,26,3,1,0,0,3,65,1,239,3,12,12,1,9,0,75,21,95,1,4,2,28,0,304,8,18,2,271,0,0,7,12,0,1,2,3,21,27,60,0,10,2,2,8,1,9,0,0,3,0,9,0,11,5,0,9,3,7,29,63,7,20,4,24,5,16,4,19,3,21,8,0,244,1,0,1,73,22,10,11,0,13,1,5,2,0,1,82,2,2,6,1,15,23,0,14,0,4,4,1,22,14,4,0,4,174,3,10,0,8,1,2,3,0,1,3,413,0,3,1,236,25,0,28,3,0,4,109,0,70,1,3,0,7,255,1,1,3,4,0,89,1,6,6,0,3,10,9,5,0,0,2,0,22,1,3,0,52,21,0,15,2,31,4,80,19,7,9,21,1,2,6,0,12,64,2,24,9,23,0,15,2,3,3,1,4,0,5,2,4,1,0,1,13,0,56,2,4,4,2,2,12,0,1,96,1,1,2,3,1,6,0,1,0,0,2,21,7,28,1,54,10,1,1,2,18,11,102,7,68,4,101,4,4,46,3,0,2,0,3,6,4,13,5,2,2,2,3,1,0,0,4,75,20,34,1,1,49,1,3,0,322,19,8,1,10,1,0,10,17,2,0,0,1,37,1,3,2,3,5,1119,2,2,0,0,0,5,71,6,4,3,0,0,1,0,4,1,98,8,13,75,0,87,6,0,0,98,3,1,0,17,0,0,3,3,3,5,3,5,26,13,2,19,6,4,30,17,0,7,10,1,1,2,9,8,14,1,2,3,1,1,0,0,0,0,17,0,4,17,4,1,7,0,2,70,5,35,1,1,14,1,18,71,1,11,1,4,8,0,8,0,6,10,5,0,2,1,0,93,0,58,1,14,3,0,0,9,4,7,1,2,0,5,4,2,38,3,64,1,0,0,130,2,18,1,62,8,3,1,0,4,3,2,4,7,17,0,3,116,2,0,0,18,3,13,6,0,0,0,2,0,5,8,1,13,4,0,15,0,0,2,1,29,12,5,5,4,1,12,1,1,2,0,0,0,0,26,0,3,11,3,0,607,3,38,3,4,3,548,2,1,0,0,0,1,2,0,2,48,1,1,0,20,20,75,3,0,0,45,1,1,7,2,6,0,9,62,24,6,6,7,4,1,59,1,1,4,11,2,81,0,2,16,27,0,2,10,10,0,0,2,2,0,0,0,23,0,0,6,4,21,2,0,0,5,3,50,135,13,3,0,1,0,813,0,11,6,0,0,55,1,12,0,0,0,4,1,0,1,0,2,1,3,1,1,19,2,2,2,82,1,16,0,3,2,0,3,4,27,0,0,268,10,10,54,2,190,0,1,1,108,2,1,6,1,3,0,11,0,1,0,2,2,0,5,1,0,2,1,1,0,287,49,4,1,0,3,1,0,0,0,0,9,4,0,1,0,23,1,2,0,2,9,9,2,2,0,1,1,4,2,0,0,3,1,0,0,7,0,6,0,2,0,1,0,0,0,1,150,1,1,0,1,0,4,28,0,2,4,15,0,4,1,2,0,0,8,1,38,0,1,2,9,0,116,5,1,0,1,2,2,58,6,9,28,0,1,0,0,0,19,0,0,2,3,9,19,65,0,2,0,2,2,0,1,12,0,10,5,0,11,17,11,0,1,0,32,0,0,3,0,1,18,0,1,1,2,0,8,0,2,5,0,0,37,5,1,7,9,5,11,6,4,10,0,15,0,1,0,5,3,0,3,1,7,63,1,3,0,5,7,0,16,63,5,0,1,0,0,0,9,0,1,0,4,4,0,1,0,3,0,1,2,13,0,3,113,0,1,0,1,1,1,0,0,0,0,49,0,2,1,4,24,0,0,1,3,0,2,13,1,66,1,1,6,0,0,1,1,3,43,0,7,0,0,0,2,6,0,0,2,6,1,0,3,20,0,0,0,3,5,0,0,0,22,8,4,1,0,61,3,7,4,0,4,0,1,3,0,0,0,1,0,127,1,26,7,1,9,0,2,0,7,6,2,0,48,0,0,8,0,0,23,0,1,169,2,0,0,2,2,0,11,0,6,0,175,7,1,0,0,0,1,30,0,0,0,0,9,0,4,2,1,9,0,0,1,12,46,10,0,1,1,0,221,45,3,1,0,3,3,0,2,267,2,0,8,1,40,1,1,2,10,0,1,26,0,5,0,0,1,3,1,1,10,0,3,1,16,1,7,2,6,0,0,0,0,3,4,2,3,1,3,6,0,2,1,4,0,1,0,3,1,0,1,0,0,16,8,1,20,0,0,17,0,0,6,7,0,1,0,0,0,5,0,2,0,3,0,0,0,4,2,5,2,10,0,0,39,0,0,0,3,69,0,0,17,30,1,7,0,3,0,0,15,13,12,0,1,3,0,5,0,0,0,4,0,0,3,8,3,0,1,5,241,110,72,0,0,0,0,5,1,1,1,1,0,5,0,1,0,2,0,0,0,1,4,5,0,7,7,1,2,1,0,0,4,2,2,2,0,14,4,1,2,4,0,0,0,0,5,2,0,3,0,0,44,0,2,1,16,0,0,0,12,3,0,8,0,1,5,0,0,0,6,0,3,2,0,0,0,0,14,14,0,8,1,0,0,15,14,0,29,0,1,0,0,14,6,1,2,1,0,2,0,0,1,0,1,35,0,0,7,0,39,2,1,0,9,0,72,3,0,0,1,0,0,2,3,1,1,4,0,0,9,0,0,2,1,0,44,7,5,0,0,1,1,1,2,0,0,0,0,0,0,14,2,0,0,0,3,0,1,0,0,1,0,0,1,0,1,9,22,0,0,0,0,2,0,1,0,12,2,1,0,1,6,0,0,62,33,0,0,1,3,2,1,0,3,1,0,4,0,0,1,3,52,2,0,4,3,5,0,0,4,3,0,2,0,0,0,0,1,0,12,0,0,0,1,0,1,0,1,1,1,6,2,3,1,3,1,2,0,7,7,4,1,6,1,2,0,0,0,0,2,0,8,0,5,0,0,6,1,2,0,0,2,1,0,0,0,0,22,264,0,1,0,0,0,1,4,0,2,1,1,2,1,0,6,0,0,1,0,0,5,0,0,9,0,27,2,1,10,1,10,0,0,0,0,1,51,0,0,0,2,2,0,0,0,0,1,13,1,2,1,0,24,2,1,35,2,1,5,0,5,0,30,0,1,0,4,0,1,0,0,1,0,0,14,0,0,3,9,0,0,4,2,1,1,0,1,0,1,1,0,2,0,0,2,0,0,0,1,0,1,11,2,0,0,0,0,2,0,0,0,8,0,15,12,3,0,0,0,0,0,0,4,2,2,2,4,1,0,7,2,0,0,56,2,0,0,0,0,0,7,0,1,0,7,1,0,0,9,0,3,5,3,0,2,0,0,9,1,0,0,1,0,0,0,18,1,0,2,2,1,11,0,4,0,0,0,1,0,1,3,0,1,6,0,3,0,66,0,7,0,0,1,2,3,0,17,0,0,0,0,0,0,0,1,0,1,0,5,1,0,0,0,0,0,40,1,3,0,2,0,1,3,0,0,0,0,0,2,0,0,1,0,0,0,0,0,2,0,1,11,3,0,0,0,0,6,3,0,6,0,3,2,3,0,0,2,0,0,1,2,2,1,1,0,0,0,0,1,30,1,0,1,0,1,0,0,7,7,2,0,0,22,0,0,0,3,0,1,0,0,0,0,0,0,0,0,0,0,1,0,0,1,0,10,2,2,0,0,0,0,8,1,1,1,1,0,1,2,0,7,3,0,0,0,0,0,0,0,1,0,0,0,0,0,0,4,0,0,0,0,0,0,11,0,0,4,0,1,1,0,0,0,0,0,0,0,0,10,0,0,0,0,0,1,5,1,2,0,0,11,2,0,0,0,1,2,0,0,0,0,7,1,0,1,0,0,5,0,3,0,0,1,1,0,44,0,1,0,8,1,0,6,0,0,0,0,0,0,2,0,0,0,0,0,66,0,5,0,0,0,0,0,0,0,2,0,0,0,2,0,0,0,3,0,0,0,1,29,0,9,0,0,3,0,0,0,0,0,0,1,0,0,0,0,0,0,0,0,0,0,0,0,0,0,2,0,0,1,0,0,0,0,0,0,0,1,1,0,0,0,0,1,13,2,0,0,45,0,2,0,1,0,0,0,0,39,0,1,0,0,0,0,10,0,0,1,1,4,0,0,0,4,1,0,1,0,0,0,0,1,0,7,1,1,4,0,0,0,3,0,1,1,0,39,0,2,6,3,1,0,0,2,0,0,16,0,1,0,2,1,0,2,0,13,0,0,0,1,1,18,1,0,0,0,1,0,0,0,1,0,2,9,0,0,0,0,1,0,1,0,1,0,0,5,1,1,0,0,1,1,4,0,2,0,0,0,0,0,0,1,1,1,0,0,0,0,3,0,1,0,0,0,2,2,1,0,0,2,4,1,1,0,0,0,1,2,6,0,0,0,0,0,0,0,2,0,1,0,2,0,0,1,0,0,0,1,0,0,1,2,0,0,8,2,0,1,0,13,0,0,0,0,0,0,0,0,7,3,1,0,0,1,0,0,1,7,2,5,1,0,0,1,0,39,0,0,2,1,0,1,1,1,0,1,0,0,0,1,0,0,0,1,3,1,0,1,0,0,0,2,0,0,1,1,0,2,0,1,20,0,0,2,0,1,0,0,0,0,1,1,0,0,8,0,0,1,0,0,2,6,0,0,0,0,3,0,0,0,1,0,0,2,0,4,0,0,0,0,2,0,0,21,2,6,0,0,0,0,0,0,0,0,0,0,5,0,0,0,0,0,0,0,46,0,0,2,1,9,0,0,1,0,0,0,0,0,0,0,1,0,0,0,0,0,1,0,1,0,0,0,5,0,0,0,3,0,0,0,0,13,4,1,0,0,0,0,0,0,0,0,1,3,5,56,0,0,1,1,4,0,0,3,0,1,2,2,1,0,0,10,0,0,5,0,0,1,0,0,0,0,0,0,0,0,0,0,0,0,0,0,0,0,0,0,0,1,0,0,0,1,0,2,1,0,0,0,0,0,0,0,2,0,0,3,0,0,1,1,34,0,1,3,0,1,0,0,1,1,0,0,1,1,0,1,0,1,0,1,0,0,1,3,1,2,0,0,0,2,4,0,0,0,0,0,0,0,0,0,0,0,1,2,0,0,0,0,2,5,0,0,1,1,0,0,0,0,0,0,2,0,0,2,0,0,0,3,0,0,0,0,0,0,0,0,0,0,0,0,1,0,0,0,0,0,0,0,11,0,0,12,1,0,0,0,0,3,0,0,1,0,1,0,0,1,0,0,0,0,0,2,0,0,0,0,0,0,0,0,0,0,0,2,1,1,0,0,1,0,0,0,0,0,0,4,0,13,0,0,0,0,0,0,0,3,0,0,0,0,0,0,0,0,15,0,0,1,3,1,0,0,0,0,0,1,0,0,0,0,1,0,0,0,3,0,1,1,23,0,1,0,3,0,0,0,0,0,0,0,0,0,0,6,0,0,19,0,0,1,0,0,0,0,0,0,0,0,0,0,0,0,0,0,2,0,0,0,0,0,0,0,1,2,0,1,0,0,0,0,0,0,0,0,0,1,0,0,0,0,0,0,0,0,0,0,1,0,6,0,0,0,0,0,0,0,0,0,1,0,0,0,1,10,0,0,0,1,0,0,0,1,0,0,0,0,1,0,0,0,0,0,0,0,0,0,0,7,0,0,0,0,0,0,0,0,0,0,0,0,0,5,0,8,0,0,0,0,0,0,0,0,0,0,0,0,0,0,0,0,0,7,1,0,0,1,0,0,0,0,0,1,0,0,0,0,0,0,2,0,0,0,0,0,0,0,0,0,0,0,4,0,0,0,0,4,0,0,0,0,0,0,0,0,0,0,0,0,0,0,0,0,1,0,1,0,0,0,0,0,0,1,0,1,0,2,0,0,1,0,0,0,0,0,1,0,0,0,0,0,2,0,0,0,2,0,0,0,1,0,0,0,0,0,0,0,0,0,0,0,0,1,0,0,0,0,0,0,1,0,0,0,0,0,0,0,0,2,0,0,0,0,0,0,0,0,0,0,0,0,1,4,0,2,0,0,0,2,0,0,0,0,0,0,0,0,0,1,2,0,0,0,0,0,0,0,0,3,0,0,0,0,0,0,0,0,1,0,0,0,0,0,0,0,3,0,0,0,0,0,0,0,1,0,0,0,0,1,1,0,0,0,0,0,0,0,0,0,0,0,0,0,0,0,0,1,0,0,1,0,0,0,0,0,0,0,1,0,0,0,0,0,0,0,0,0,0,0,0,0,1,0,0,0,0,0,0,0,0,0,0,0,0,0,0,0,0,0,0,0,0,0,0,0,0,0,0,0,0,1,0,0,0,0,0,0,0,0,0,0,0,0,0,0,0,0,0,0,0,0,0,0
"Breast Cancer",8839,2753,2727,36501,1733,1505,1537,1863,6228,1863,1279,3241,1806,1045,1708,1993,10746,4168,892,961,2216,858,49826,3343,707,318,1689,422,1588,329,1329,2732,499,159,1149,696,385,462,503,443,15646,9412,2022,963,962,3741,171,105,2809,668,221,126,512,1880,170,711,279,602,11001,2383,11825,432,223,1367,19024,1064,3431,856,112,233,562,202,197,188,1480,589,343,4517,137,1943,2201,6712,2814,2005,5044,551,3522,175,238,414,372,4833,250,173,2459,301,751,1300,260,1677,458,789,613,154,403,599,767,604,193,20818,234,107,3478,776,341,126,1333,206,435,170,212,167,182,4198,290,891,14037,204,654,307,220,2609,2092,585,947,601,1008,360,1409,157,161,1124,106,186,431,989,287,451,115,192,5263,121,1590,359,903,458,2593,3496,653,276,115,271,661,361,108,93,4947,358,251,147,3419,53,120,283,87,145,429,207,455,91,115,9668,4784,63,152,898,1106,228,103,188,871,71,116,326,614,865,321,137,1521,734,58,26,48,149,131,116,608,2560,102,4540,341,209,4898,1044,63,2222,154,74,203,82,180,72,40,83,139,63,389,3979,729,156,240,1574,192,115,286,350,96,20128,363,52,139,16,447,286,67,415,195,104,1079,270,257,65,123,58,601,2041,54,781,323,1196,2388,34,354,805,742,151,2463,1974,995,125,787,925,301,154,31,34,105,57,142,1103,1188,125,48,209,58,37,667,24,115,353,41,21,28578,55,34,66,78,135,547,132,256,157,119,459,147,470,186,20,122,97,65,56,1821,312,1403,264,62,63,3383,29,86,21,72,68,117,585,117,30,104,123,100,83,365,51,40,70,52,42,5,794,469,109,415,158,413,13,348,111,65,23,200,24,36,27,53,44,67,110,22,79,36,57,400,86,54,1321,24,666,18,24,35,2486,49,73,151,119,294,48,97,107,251,196,93,311,53,84,330,31,370,42,150,428,8,97,18,131,54,36,664,99,36,119,122,36,731,35,85,1171,813,81,82,28,162,1726,70,72,44,148,208,37,162,169,183,68,24,103,41,96,40,60,29,29,280,92,49,35,74,97,14,65,123,16,25,83,13,56,569,35,109,121,42,114,28582,478,72,11,16,33,458,169,57,26,27,73,28,498,1882,13,27,55,538,285,39,397,221,323,25,78,26,48,53,189,34,1278,38,50,51,220,551,15,223,27,299,40,725,34,38,218,56,82,196,16,1349,13,59,59,53,16,207,47,35,547,325,55,22,117,164,215,17,163,22,94,41,101,74,2398,17,28,13,12,32,93,1870,652,120,157,220,22,26,1374,444,113,292,18,230,80,181,36,150,24,15,40,24,11,575,17,102,50,46,187,280,76,701,27,12,131,53,32,35,37,28,24,1101,63,14,43,204,9,31,39,78,10,86,587,524,1621,36,32,11,21,96,32,34,216,92,29,194,68,30,77,12,192,434,16,13,73,75,53,88,12,215,39,69,103,36,1215,48,65,42,75,510,41,83,20094,104,79,36,170,9,59,1330,22,1546,67,55,46,13,202,224,61,319,16,14,258,797,53,28,18,14,100,19,68,61,17,5,17,10,55,33,1,52,261,30,34,300,43,6,18,511,58,120,38,62,22,429,11,58,20,75,301,102,76,177,114,616,86,699,833,62,35,612,235,347,30,44,58,170,304,13,3846,69,77,104,26,53,4,98,1243,14,18,15,63,54,11,50,1173,153,7,2,81,63,461,31,25,77,204,57,14,19,23,161,112,101,25,23,45,95,18,13,498,26,18,43,65,14,18,173,23,34,22,179,16,382,103,138,393,4,25,19,54,23,2455,14,99,100,51,70,192,44,89,20,36,6,8,317,55,159,18,1542,8,24,519,27,18,63,12,16,54,21,485,15,16,781,48,230,19,19,38,15,54,83,38,16,91,139,87,15,267,21,320,8,32,31,11,18,9,1,732,16,25,72,11,109,107,15,62,85,24,2,85,20,69,6,30,151,2628,7,93,17,16,169,24,15,390,6,73,12,5,4,10,18,173,61,12,84,58,11,1096,8,22,2,182,754,54,227,30,13,58,19,139,37,163,6,15,2,50,188,29,25,179,7,35,267,31,16,9,19,13,0,41,481,29,138,113,52,29,246,160,69,244,19,28,34,8,9,36,41,133,20,43,17,7,57,34,202,34,286,5,254,57,4,24,632,13,91,14,52,10,261,227,25,250,148,18,36,6,321,7,10,28,58,740,894,2072,24,16,353,8,822,19,262,17,40,6,7,1,156,11,8,257,55,18,198,304,440,5,227,14,11,39,19,58,69,59,9,4,147,993,243,49,4,27,12,175,2,243,78,11,123,9,32,19,8,4,28,24,39,9,72,16,137,7,235,16,8,63,10265,28,15,2,288,145,10,16,20,99,17,21,49,3,37,18,56,20,2,1,92,41,20,1,14,31,24,20,14,124,71,137,2,12,0,9,60,53,58,271,5,14,23,14,17,16,109,13,5,4,71,12,254,23,24,3,1260,35,1,5,2,2,140,69,2,19,121,6,15,3,176,6,301,19,31,13,6,328,4,3,9,7,2,5,13,254,9300,8,25,42,28,12,13,52,22,33,27,14,11,14,31,7,9,13,4,29,11,28,356,9,46,4,54,11,10,102,1343,19,9,0,20,21,5,7,11,582,6,42,3,17,11,7,41,23,21,46,81,10,15,11,4,18,125,16,3,1010,24,50,37,5,11,46,9,13,7,16,7,24,14,6,20,98,29,0,4,7,16,240,26,2,23,33,6,19,4,4,266,67,16,7,47,12,106,2,15,80,627,1,9,29,1,46,10,7,6,20,13,29,68,33,4,6,4,8,14,12,29,8,3,6,2,114,15,46,7,10,51,18,16,770,362,24,115,8,32,70,165,9,80,11,198,45,2,11,20,0,13,156,116,47,201,13,19,9,4,11,3,84,873,51,7,48,21,25,31,4,85,10,4,44,1,77,39,74,8,14,11,8,22,29,25,15,37,13,3,4,5,1,7,21,1,517,42,13,353,7,4,12,682,3,10,2,20,3,12,413,10,202,16,23,2,4,10,36,63,2,17,5,37,40,6,6,3,2,2,17,18,11,32,116,4,219,10,54,57,40,17,7,12,33,6,8,40,5,105,145,61,247,28,637,0,59,24,4,39,4,2,9,38,25,30,2,6,4,13,9,130,104,4,41,10,24,100,15,9,173,8,8,13,8,15,184,4,160,2,1,19,106,28,107,19,351,95,8,3,11,125,11,183,36,4,34,137,2,13,4,8,3,4,1,8,12,51,54,18,17,7,8,12,5,19,3,47,102,13,146,1,15,155,19,10,8,6,8,7,22,80,7,3,15,221,8,8,4,21,34,5,92,1,13,13,7,14,60,12,4,10,27,21,9,47,12,2,4,5,4,3,3,27,22,33,390,2,390,10,3,3,139,10,10,1,21,9,19,3,23,34,18,5,13,781,1,22,27,31,1363,166,62,2,9,7,1,4,4,12,52,34,3,12,4,56,6,6,1,1,9,37,2,2,621,22,20,14,10,44,11,10,395,7,3,28,1,13,20,5,17,3,90,3,9,8,1,24,6,77,0,4,10,3,10,3,206,5,84,17,0,2,48,80,48,7,56,0,6,25,11,26,13,15,6,3,0,132,0,171,1,381,24,5,4,3,6,1,5,7,5,124,5,28,24,49,3,6,39,8,3,20,5,1,6,23,4,12,13,2,7,8,0,979,9,8,7,0,117,65,116,112,15,5,32,3,1,18,6,3,0,2,52,0,87,33,7,6,2,13,205,10,13,14,29,54,2,3,10,3,0,39,4,3,7,4,17,5,81,16,23,5,85,1,57,5,3,21,14,4,2,13,7,84,8,102,140,2,9,209,14,8,19,11,10,320,3,2,15,2,1,0,1149,66,0,8,28,7,20,11,1,35,4,0,78,56,4,3,10,3,13,121,4,8,17,74,2,13,3,6,6,571,10,2,8,4,14,32,1,5,4,10,1,3,11,5,1,2,5,5,0,92,3,17,1,21,1,45,0,15,19,0,3,31,73,8,4,344,34,17,192,89,313,3,11,4,8,4,5,10,12,31,1,60,3,0,85,18,37,25,26,5,2,6,0,0,3,6,120,8,5,1,5,19,5,7,10,1,11,4,7,6,4,29,6,4,6,9,55,81,9,16,0,0,1,16,47,0,1,14,12,1,9,180,13,11,0,8,8,0,3,6,1,44,12,15,7,0,4,7,5,6,8,2,87,17,5,6,56,0,1,2,2,3,68,10,12,19,74,0,10,226,0,2,22,1,5,208,128,42,71,8,10,32,6,3,127,2,5,6,22,424,12,23,6,7,3,2,14,0,9,119,2,65,9,10,6,76,3208,6,13,2,9,3,0,2,0,1,0,1,2,0,133,0,69,2,11,9,6,4,165,31,1,3,158,9,11,87,5,76,4,57,18,13,0,17,16,1,0,3,18,28,8,2757,15,6,34,5,29,7,7,8,20,7,0,1,58,0,19,1,1,12,1,2,2,15,1,4,41,3,1,8,20,4,4,2,1,4,11,0,0,5,0,206,2,2,4,2,33,0,2,8,3,0,7,44,16,26,0,1,5,3,23,6,2,7,11,1,13,1,1,3,10,7,3,4,46,19,1,6,44,63,1,4,1,67,20,1,1,2,32,47,18,0,2,1,1,0,11,2,0,3,3,7,1,5,3,4,0,258,7,1,3201,4,0,2,9,4,10,1,2,0,56,1,0,5,1,0,11,17,0,63,22,6,0,23,6,3,4,3,27,1,146,25,8,5,6,1,4,7,2,0,5,9,24,2,23,12,1,9,0,5,2,1,339,121,0,10,2,17,6,73,10,9,1,7,6,11,4,0,3,0,42,5,10,0,4,27,12,0,3,41,1,10,0,1,21,183,3,6,60,6,16,1,37,3,64,6,41,1,2,2,1,7,14,5,18,165,56,84,1,4,8,23,5,1,0,5,8,6,3,8,3,36,21,0,683,1,5,80,0,15,3,58,20,1,0,0,16,12,4,28,2,8,1,9,4,24,14,15,12,54,9,1,208,9,11,2,40,82,0,1,2337,129,8,212,8,9,20,0,28,28,53,2,3,3,7,10,1,0,4,36,4,0,3,2,6,2,1,26,1,2,13,2,1,1,0,16,16,1,3,4,1,11,0,6,2,8,3,0,1,4,8,27,0,7,13,6,13,12,3,1,7,9,11,12,1,140,9,1,0,9,0,1,1,2,23,16,1,373,4,0,12,1,10,0,3,0,1,1,3,124,9,31,2,12,11,0,3,3,5,6,0,6,6,0,0,0,1518,2,0,14,1,2,1,43,21,15,517,2,4,2,3,6,2,1,23,3,3,6,2,0,2,2,2,98,3,4,0,0,14,14,8,0,16,1,3,6,0,2,1,0,1,1,10,1,10,20,0,0,7,8,5,11,1,5,14,11,77,1,6,12,5,1,6,2,0,0,1,4,0,26,54,1,0,1,5,1,0,2,0,0,4,12,21,0,1,19,35,0,1,3,221,10,6,7,5,33,5,0,0,4,18,3,0,242,79,1,1,5,5,1,6,0,1,3,8,47,2,1,2,29,72,3,2,24,8,334,3,8,13,5,1,3,0,0,5,0,6,3,30,0,9,2,0,0,2,2,71,2,1,15,11,1,1,2,17,21,7,48,30,60,4,31,0,7,3,16,2,1,2,3,4,0,65,7,0,18,9,1,0,6,6,0,2,1,0,4,141,3,3,2,2,0,0,7,24,3,110,4,7,24,0,0,19,2,3,6,13,7,13,2,1,61,0,25,1,5,3,11,26,3,9,2,1,5,56,1,2,0,37,17,1,2,1,0,1,24,1,1,21,0,5,14,22,579,44,1,37,0,2,5,724,2,0,16,28,1,37,1,2,0,0,0,1157,2,7,1,26,2,2,28,2,0,2,24,6,3,1,0,0,2,0,1,4,1,0,0,5,14,16,40,18,0,2,4,3,6,0,0,0,45,37,11,4,0,12,5,1,1,1,0,4,8,0,13,13,6,0,12,7,2,5,0,2,4,1,1,3,12,2,3,1,0,19,1,4,2,21,0,11,12,23,10,2,1,9,20,0,1,2,3,2,3,4,55,4,2,3,4,2,527,2,3,2,1,3,2,5,25,112,1,5,1,0,10,7,90,3,11,0,0,3,10,25,2,1,0,1,1,2,1,2,6,1,0,10,27,5,12,0,1,2,1,1,7,3,18,0,10,0,0,238,1,6,1,0,0,3,2,0,4,0,1,0,3,0,0,3,1,2,6,7,4,4,2,1,45,481,1,0,7,3,20,2,2,13,0,1,0,12,1,0,0,1,1,4,14,0,313,11,2,74,4,0,1,6,19,2,10,3,1,9,0,2,2,9,0,2,0,0,0,2,2,1,0,1,2,0,1,0,4,6,2,0,4,0,0,1,2,8,0,2,1,2,1,5,0,6,2,7,17,8,3,1,0,0,1,1,2,2,3,0,5,0,2,22,0,2,0,0,2,9,81,0,0,7,0,2,2,0,1,0,0,0,1,4,3,44,1,1,0,0,3,1,0,15,0,0,10,4,1,2,4,0,4,63,0,1,5,1,32,9,10,13,0,2,9,0,12,0,3,2,3,1,0,2,4,5,1224,1,0,21,0,0,1,0,1,1,1,1,2,1,41,0,2,1,11,0,0,1,0,0,0,2,8,5,1,2,3,0,0,1,0,0,4,3,9,14,6,11,1,2,1,1,0,1,5,1,0,6,0,1,9,1,1,1,0,1,1,2,1,2,1,1,4,0,0,18,6,0,0,4,1,0,4,0,936,1,1,0,1,0,0,7,0,3,4,4,0,0,3,0,0,2,0,10,0,1,2,1,3,1,0,4,5,2,22,4,3,2,1,3,2,15,4,3,2,2,0,56,13,841,3,0,2,0,4,0,5,1,7,0,0,2,3,0,2,14,5,4,1,5,0,0,112,1,6,6,2,30,1,3,0,80,4,1,0,2,3,63,2,2,1,0,2,0,0,1,3,54,1,31,0,1,0,0,8,3,3,0,4,5,0,1,1,7,5,4,2,2,8,0,0,8,0,0,6,1,3,1,8,7,2,1,0,8,5,0,0,1,0,3,1,2,6,1,2,6,4,6,1,1,0,3,2,2,46,0,3,6,0,0,1,0,2,1,1,0,13,1,0,0,2,0,0,5,1,0,3,1,0,2,0,7,1,25,0,4,0,0,0,0,0,1,0,0,5,16,1,0,0,2,0,0,0,36,2,173,1,5,7,3,0,3,1,6,21,276,0,1,6,0,1,1,9,3,0,0,0,0,0,4,5,1,0,3,0,4,0,8,1,0,1,1,2,19,0,0,64,0,0,10,2,0,1,1,1,2,0,8,0,0,13,4,0,4,0,1,4,15,1,0,0,2,11,0,3,0,2,6,2,30,1,0,1,0,1,0,54,1,0,0,50,0,2,0,0,0,0,2,0,0,0,5,16,4,0,0,0,0,3,0,4,0,3,1,2,79,6,2,7,9,5,0,0,2,0,0,3,0,0,1,2,1,1,2,1,0,1,0,11,2,1,0,56,0,1,8,0,54,6,0,40,0,1,0,1,0,0,1,6,22,15,0,0,5,0,7,5,0,0,10,2,0,0,2,1,2,0,44,1,0,8,1,0,4,0,1,0,1,0,0,0,4,0,0,4,0,8,0,0,0,0,0,1,2,0,0,1,6,2,11,0,0,2,1,1,0,1,2,15,2,0,2,0,3,2,0,79,0,7,12,1,4,7,0,5,6,0,0,40,10,0,0,1,2,1,1,2,250,0,50,2,19,9,0,0,0,14,4,2,1,0,0,0,0,0,1,18,0,4,5,1,1,3,0,7,1,1,0,3,11,0,0,0,2,1,0,5,17,0,4,1,0,1,38,1,2,1,0,5,0,0,0,0,2,0,1,1,6,0,1,1,2,0,0,30,1,0,0,0,0,0,1,0,12,3,0,1,0,27,0,3,2,0,6,1,1,1,2,2,0,14,0,0,0,3,0,0,0,0,0,7,0,1,0,170,0,0,0,6,0,2,17,0,5,0,2,0,0,4,1,0,2,2,2,2,0,0,2,2,1,12,1,0,4,16,0,0,2,0,0,1,25,1,1,1,0,6,3,0,1,11,0,52,6,0,1,53,0,0,0,1,0,0,4,0,1,0,0,0,0,0,1,14,0,0,0,2,0,13,0,0,3,0,0,0,0,1,1,1,0,9,0,0,0,0,12,2,0,2,129,1,6,0,1,0,0,0,0,0,0,0,1,0,0,0,0,0,2,0,1,1,0,2,4,9,0,1,0,0,0,8,0,0,0,0,1,3,1,0,5,0,0,0,4,0,0,3,0,1,0,0,0,0,0,0,0,0,0,1,0,0,2,1,1,10,6,1,0,2,1,0,0,0,1,2,0,0,2,0,0,2,1,1,1,2,0,0,0,0,0,2,0,0,3,0,3,0,1,3,3,0,3,0,1,0,0,3,0,3,0,0,0,0,1,3,5,0,1,4,0,1,0,0,0,0,1,8,0,0,1,1,38,1,0,1,1,0,0,0,0,0,0,0,0,0,0,0,0,1,2,0,0,0,2,0,0,0,1,0,0,0,0,0,1,0,0,229,0,0,0,0,3,0,0,0,0,1,0,1,0,0,0,1,0,0,0,1,0,0,1,0,0,0,0,2,0,1,1,0,0,0,1,0,4,0,1,2,0,1,0,0,5,0,0,0,0,1,0,0,8,1,2,0,0,0,0,0,32,0,2,0,0,0,0,1,0,3,0,0,0,2,0,0,1,0,0,2,0,70,0,0,1,0,0,1,0,1,0,0,0,1,1,0,0,0,0,1,1,0,0,4,0,0,1,1,0,0,0,2,0,0,0,0,1,0,0,1,0,0,3,0,0,1,1,0,0,0,3,0,0,0,2,0,0,0,0,1,1,1,0,0,0,0,0,0,0,0,0,0,0,0,0,0,0,1,0,0,0,1,0,0,0,0,0,0,0,0,0,0,0,0,0,0,4,1,0,0,0,1,0,0,0,0,0,18,2,0,0,0,0,0,0,0,0,0,0,0,0,1,0,0,0,0,0,0,0,0,0
"Cervical Cancer",1404,379,561,10271,129,1456,199,168,568,524,236,440,130,159,372,109,2296,332,391,592,371,111,11121,256,29,42,298,406,309,28,396,673,65,134,260,1966,121,88,166,34,4985,2132,275,69,148,738,21,53,203,219,52,17,49,303,55,130,254,143,969,587,1713,315,53,38,5743,218,669,251,30,1411,65,48,45,127,131,86,15,319,91,411,294,2528,600,405,1177,139,908,38,11,81,225,776,1159,58,390,11,126,599,42,294,302,215,387,65,60,15,182,131,18,7595,106,9,151,53,72,55,54,98,20,45,81,17,25,696,57,157,4102,319,99,163,43,428,670,73,149,194,124,44,155,40,10,200,55,86,140,194,32,143,9,26,1644,25,323,102,73,22,394,516,69,64,18,136,7,14,14,12,1270,63,51,50,472,5,51,33,21,39,136,46,92,17,80,2091,672,8,28,132,538,32,14,25,159,15,21,43,6,64,99,60,31,83,13,17,43,8,244,38,139,508,8,806,17,32,971,80,13,179,99,2,34,18,207,17,4,19,13,27,39,510,131,67,49,352,21,7,86,43,14,5877,35,10,28,10,732,735,4,65,60,17,149,67,85,23,23,10,183,262,12,132,38,117,61,8,97,224,637,275,421,478,163,10,77,116,40,85,8,6,38,5,57,2032,184,49,20,43,28,2,98,2,43,28,3,14,200,18,40,88,44,7,113,23,269,13,22,102,14,102,27,5,217,16,11,7,310,186,379,55,47,5,1774,7,9,11,33,125,27,117,15,35,37,6,22,46,70,3,147,22,2,14,1,105,95,52,44,25,355,3,8,14,9,10,53,4,11,13,10,39,6,15,10,16,11,5,86,232,156,109,5,99,11,0,26,1366,10,292,18,40,45,7,22,1,63,27,11,103,19,8,31,225,185,13,22,86,3,14,4,42,14,11,644,23,294,17,22,13,70,4,26,617,247,7,48,8,12,598,38,9,2,27,429,3,20,81,45,62,7,54,16,0,10,14,20,66,38,19,39,7,14,10,4,66,17,2,5,9,2,21,220,79,3,14,17,117,163,83,14,2,9,4,233,96,89,5,36,16,5,84,267,4,10,13,85,56,12,63,78,26,7,30,7,12,5,30,5,95,8,0,21,1010,76,2,164,8,24,20,766,3,18,38,7,7,14,3,110,1,19,3,332,3,76,5,15,783,23,11,5,19,16,83,18,16,14,29,12,18,6,961,6,11,2,3,1,25,3398,885,12,29,62,3,31,460,228,11,1100,16,55,35,28,28,19,347,2,8,1,1,201,34,7,9,138,67,65,6,15,10,6,27,12,10,18,7,16,24,72,17,3,10,613,2,3,19,34,1,29,35,21,26,101,5,1,6,17,5,4,102,27,3,23,10,9,59,6,46,92,5,23,21,8,14,16,9,36,16,1,66,1,133,9,31,13,26,60,5,45,216,6,19,4,238,3,2,1148,0,669,4,6,10,4,29,6,18,115,16,11,22,130,44,14,1,54,218,161,2,3,1,2,296,1,2,10,1,6,17743,3,9,25,4,2,27,147,62,34,1,11,6,69,1,364,5,23,21,8,49,27,81,31,17,115,117,47,2,590,47,84,1,11,8,25,14,5,315,272,8,6,3,0,20,16,8,1,11,9,1,93,5,2,1577,66,0,5,12,3,24,6,84,19,76,6,31,7,4,10,59,70,7,6,17,74,1,3,56,4,15,19,24,3,5,18,6,28,3,22,2,116,19,8,32,1,6,7,7,5,23,1,282,49,114,15,14524,190,22,4,15,3,12,37,11,340,2,492,33,10,296,16,5,2,6,1,1,5,40,2,2,112,2,4,2,1,0,7,8,2,6,1,12,61,12,1,27,3,49,25,19,12,0,2,4,3,34,7,16,16,0,42,4,3,2078,447,8,1,13,0,52,6,17,23,104,31,28,2,6,15,10,7,66,4,12,2,3,0,3,38,28,7,3,13,12,5,269,1,0,2,72,27,15,63,6,3,0,21,27,28,25,1,31,1,80,52,4,1,71,9,9,127,14,44,0,6,5,0,10,239,4,7,100,7,26,31,57,28,288,3,5,17,3,0,7,8,18,40,4,19,0,6,9,38,5,291,4,41,16,0,8,136,6,4,12,25,0,66,76,2,39,17,5,19,1,16,3,2,27,2,117,6,539,0,5,15,2,164,5,30,0,11,10,2,1,8,2,0,45,179,0,23,69,51,0,46,10,7,15,4,16,10,9,0,0,17,76,11,5,2,0,1,4,3,128,15,0,51,35,13,3,486,2,6,2,1,1,3,3,16,0,51,6,12,5,30,1,14,3,20,17,2,36,1,19,1,2,8,1,6,5,67,2,3,53,12,18,8,1,2,50,6,153,0,11,21,73,0,1,0,21,4,5,14,38,14,3,6,3,9,6,95,4,2,0,14,0,55,4,4,0,254,19,0,40,7,0,58,10,2,25,6,0,10,0,85,11,23,10,26,4,2,273,18,2,5,0,4,1,3,50,95,57,10,9,14,5,5,17,16,3,1,2,9,4,12,0,3,2,1,1,9,8,32,4,5,1,42,3,2,16,65,5,0,1,13,1,0,1,11,271,3,35,0,2,3,0,7,48,2,11,23,4,3,0,0,2,16,1,0,1509,36,7,32,0,220,36,1,4,0,2,7,3,3,0,30,11,6,0,1,1,5,73,4,13,2,3,7,11,16,0,39,16,221,2,8,3,20,0,11,7,210,1,233,0,0,6,51,2,0,5,4,23,8,21,0,0,0,3,1,1,12,0,0,5,0,19,33,5,2,1,25,3,1,47,43,7,89,5,24,5,12,6,11,1,63,2,2,10,2,1,1,85,17,8,7,0,3,0,2,1,3,9,46,67,1,11,9,14,7,0,85,2,1,8,5,7,11,19,1,1,60,0,3,14,4,13,4,4,1,0,1,13,2,52,0,663,12,1,21,0,0,4,1050,5,6,5,4,1,2,222,2,5,3,3,1,9,5,7,107,2,3,0,8,1,0,0,0,1,8,3,5,0,264,53,1,258,9,36,3,178,17,12,2,19,3,0,5,7,12,27,0,26,14,522,0,117,2,3,6,2,15,2,7,11,8,1,0,0,68,4,29,17,4,2,2,20,15,1,0,84,0,0,4,3,4,27,1,12,0,2,4,16,15,447,2,477,8,0,0,0,18,1,15,11,3,2,36,4,74,23,8,4,0,4,3,2,10,8,5,2,5,2,4,0,4,0,8,319,11,26,2,1,24,39,0,0,488,2,3,2,122,2,0,3,192,0,0,0,6,3,1,8,2,17,7,335,3,8,0,0,0,10,32,5,7,4,1,5,0,1,1,0,14,5,4,67,0,85,13,1,0,68,1,3,1,13,1,3,1,6,2,8,2,72,31,2,11,64,4,21,26,4360,0,0,1,0,4,0,4,5,88,2,1,0,9,0,0,0,0,29,17,0,0,11,3,3,5,1,0,1244,9,186,0,0,51,0,1,31,2,11,1,2,1,3,1,1,4,2,61,1,0,0,0,0,0,132,2,12,5,4,0,4,1,8,0,5,0,3,0,0,8,66,28,4,1,0,17,1,11,0,50,7,3,0,0,4,2,2,2,27,29,0,2,29,3,0,0,9,3,0,21,2,0,3,28,0,199,12,1,12,11,0,6,1,9,2,0,13,9,7,1,5,9,8,0,2,4,0,0,0,13,25,0,3,11,1,30,10,3,34,5,2,1,47,3,0,1,0,1,0,11,2,1,7,1,1,3,16,5,16,5,7,0,48,0,2,1,6,181,0,7,10,13,1,4,62,0,1,26,0,6,2,1,0,157,1,1,14,1,0,0,18,14,0,8,5,4,4,2,0,3,3,0,29,4,10,1,2,3,1,2,2,278,10,4,0,0,1,15,0,21,0,1,0,3,3,15,1,0,0,9,0,0,1,2,0,1,1,1,1,27,0,3,0,55,1,18,1,2,1,0,0,45,14,0,2,74,11,0,33,20,86,0,2,2,18,1,0,0,1,4,1,6,0,0,13,3,0,3,3,2,0,0,3,0,0,21,50,3,49,0,0,3,0,1,1,3,3,2,4,2,2,7,2,11,1,2,16,8,2,6,0,0,1,2,3,0,0,2,1,0,1,9,6,4,0,0,2,4,0,1,8,5,16,0,0,0,1,0,175,9,1,1,5,7,1,0,0,5,0,0,3,1,6,0,2,0,23,1,2,22,3,6,1,0,0,1242,59,161,6,5,1,7,4,0,39,0,0,2,9,22,1,7,1,2,3,0,2,1,3,7,1,13,1,0,6,5,22,0,1,2,1,1,0,1,0,1,12,0,0,0,6,0,28,0,2,8,1,1,114,0,2,1,92,12,2,4,1,12,1,25,2,17,0,2,4,0,20,0,4,18,2,11,1,0,8,13,2,5,0,3,1,4,0,0,121,0,4,1,1,11,0,1,0,5,1,0,7,1,0,0,3,13,3,2,1,1,23,0,0,1,0,65,0,0,1,2,13,2,0,7,1,0,1,10,2,9,0,1,13,0,0,1,1,1,0,0,2,0,0,1,1,15,0,2,1,3,0,0,3,29,0,1,5,124,3,0,0,3,10,8,2,0,0,2,0,0,1,0,0,1,0,4,1,0,0,0,0,68,1,2,31,0,0,0,1,0,1,3,0,0,22,3,0,0,0,0,9,2,5,134,2,5,0,2,0,1,4,1,11,0,70,11,3,1,1,1,0,3,2,1,0,0,7,3,7,20,0,2,0,0,5,7,41,13,0,2,1,1,278,10,3,0,0,2,0,0,1,7,1,2,7,0,4,0,0,2,3,0,1,24,0,12,0,0,0,5,1,0,6,3,1,0,5,0,4,2,1,0,0,0,0,1,6,5,880,6,12,63,0,0,2,37,0,1,0,8,5,1,0,1,0,7,60,0,26,0,0,76,0,0,0,34,1,2,0,0,4,1,0,3,1,0,2,1,55,19,4,7,1,7,0,0,12,18,0,0,3,20,0,0,10,52,0,92,1,4,4,0,9,11,8,1,1,0,1,1,0,0,2,8,0,0,0,1,1,2,0,6,17,5,9,1,0,0,0,0,0,0,0,2,0,20,0,1,1,2,5,1,0,6,3,2185,0,0,4,2,0,5,3,0,1,2,0,0,0,7,62,0,0,2,0,1,0,1,11,5,0,38,2,0,168,0,0,0,1,0,0,0,1,6,0,29,1,1,0,0,2,0,7,1,0,4,3,0,0,0,45,0,0,3,0,3,3,3,2,1,16,0,4,0,0,2,1,0,0,2,0,0,0,0,0,0,0,43,1,0,3,0,102,10,2,0,2,0,202,6,0,0,0,1,1,1,3,0,1,7,0,1,1,4,0,2,1,1,106,3,28,0,0,0,2,3,3,0,12,0,0,2,0,24,7,0,0,2,0,0,5,0,0,1,2,2,1,0,0,10,11,0,0,1,2,1,3,6,3,17,1,0,0,1,3,0,0,30,22,0,0,0,2,0,2,0,0,0,0,23,0,1,0,5,40,2,0,1,0,9,0,2,2,3,1,6,0,3,6,0,7,0,10,0,0,0,0,0,1,0,0,0,0,14,0,7,0,1,0,3,0,5,4,4,24,9,3,0,1,0,7,0,0,3,0,0,6,0,1,4,2,0,1,0,2,0,0,0,4,1,79,20,0,0,0,0,0,0,3,0,42,0,2,13,0,0,43,0,3,0,1,1,22,1,0,20,0,14,0,1,2,15,7,0,0,0,0,0,83,0,0,0,9,7,0,1,1,0,1,0,2,0,2,0,11,4,0,96,2,1,22,0,2,0,13,0,0,2,7,0,1,0,0,0,0,0,24,0,0,0,8,0,0,3,1,1,0,4,0,1,5,1,8,2,0,2,1,0,0,0,3,0,0,9,2,0,0,0,0,3,0,0,0,1,2,20,8,0,2,1,0,0,0,0,0,0,60,10,4,0,0,6,4,3,0,1,0,30,0,0,0,1,36,2,1,0,1,0,6,0,11,0,0,2,8,0,1,0,0,3,1,0,1,0,1,1,0,80,1,1,0,0,0,9,0,0,5,0,0,0,1,0,30,1,5,5,0,0,6,42,0,4,0,0,0,38,11,1,4,0,3,1,0,0,0,0,9,0,2,2,1,2,0,0,0,0,0,2,1,8,0,1,0,1,5,0,0,0,0,0,1,1,0,0,1,2,5,0,0,0,2,0,1,26,0,1,0,0,1,1,1,1,0,1,1,0,1,0,5,0,1,1,0,1,4,0,0,0,0,8,1,26,26,0,0,1,1,0,0,1,1,2,0,0,9,0,1,0,4,1,0,1,0,0,0,1,2,0,1,0,0,1,0,0,0,0,0,2,0,0,0,0,4,8,0,7,0,7,2,0,0,0,0,4,0,1,0,0,0,0,0,4,0,2,0,0,0,0,0,0,0,0,11,8,3,5,0,0,0,0,2,4,0,0,0,0,0,0,2,0,1,0,0,0,0,0,0,2,2,0,0,2,0,1,0,1,0,0,3,0,4,0,0,7,1,3,0,0,0,1040,0,7,0,1,0,1,0,1,2,10,5,19,1,1,9,1,2,0,0,1,0,0,0,7,1,5,0,4,0,5,0,0,0,0,0,0,0,1,0,2,0,1,0,0,7,0,0,2,0,0,3,10,1,0,0,22,1,0,0,2,0,0,1,0,0,35,0,0,0,1,5,0,0,0,0,1,0,0,0,0,2,0,0,0,0,0,0,33,3,0,0,0,0,2,0,4,1,0,0,0,0,0,0,0,0,0,0,0,3,0,2,1,0,1,0,1,0,3,0,13,60,0,0,0,4,1,1,2,3,0,0,0,2,0,3,3,1,0,0,17,0,3,1,10,0,0,3,1,0,0,0,1,0,0,0,0,0,71,0,0,1,0,2,1,0,0,107,0,0,1,0,0,18,0,0,0,0,0,0,1,0,0,3,0,20,0,0,0,0,16,0,3,0,0,0,0,1,0,1,0,3,0,2,13,0,2,0,0,0,0,0,0,0,2,1,0,0,1,0,5,1,0,0,0,1,0,4,1,0,0,3,1,3,1,0,0,0,41,1,6,0,0,0,0,1,0,0,1,0,0,0,11,0,0,0,0,0,0,2,0,0,0,0,2,1,1,0,0,3,0,1,0,0,0,0,0,0,6,0,11,1,0,0,0,0,0,0,0,31,38,11,0,2,0,1,0,9,1,1,26,0,0,0,2,0,3,1,2,1,0,0,0,0,0,0,1,0,0,1,0,3,0,1,0,0,8,2,0,4,1,0,4,0,0,1,0,0,0,0,0,0,1,0,0,0,4,0,0,0,0,0,5,14,0,0,1,3,1,1,0,1,0,0,0,0,0,4,0,1,0,0,3,8,0,1,7,2,0,0,0,0,0,0,0,0,0,0,7,2,0,0,0,0,1,0,0,3,0,2,0,11,0,0,5,0,0,2,0,0,0,0,1,0,0,1,0,0,0,1,0,1,0,0,3,0,0,0,4,0,0,0,3,16,6,0,0,0,1,2,0,10,0,0,1,5,1,0,0,3,0,0,300,0,0,0,0,1,2,1,1,0,0,103,0,0,9,0,0,2,0,0,0,0,0,0,0,0,0,0,0,0,1,0,0,0,0,0,0,1,0,0,0,0,0,20,0,1,0,0,0,2,0,0,1,0,0,0,0,0,0,4,0,0,1,11,0,0,2,0,5,0,0,0,2,0,0,0,7,39,0,0,1,1,1,1,0,3,3,0,0,0,10,1,0,2,0,1,0,0,0,0,1,1,1,12,0,0,1,0,3,0,0,1,1,0,0,0,0,0,0,0,0,0,1,0,0,0,0,10,0,0,1,0,0,0,0,0,0,0,0,0,0,2,0,0,0,0,0,0,5,0,0,4,0,0,0,0,0,0,0,0,1,0,1,0,1,0,0,0,0,0,0,0,5,0,1,0,0,0,1,0,0,0,0,2,0,0,0,0,14,0,0,0,0,0,0,0,1,4,0,0,0,0,0,0,1,0,0,1,0,0,0,0,0,0,1,0,3,1,11,0,0,0,0,0,0,0,0,0,0,0,1,2,0,1,3,0,0,2,0,0,5,0,0,0,1,1,0,0,0,0,0,0,0,0,0,0,36,2,0,0,0,0,3,0,0,0,0,0,0,0,0,0,0,0,0,0,0,0,0,3,0,1,0,3,0,2,1,0,0,0,0,0,0,0,0,0,0,0,0,0,0,0,0,0,0,0,1,0,7,0,0,0,0,0,0,0,0,0,2,0,0,0,1,3,0,0,0,4,0,0,1,1,0,1,0,0,0,0,0,0,0,0,1,0,0,0,0,0,0,0,0,0,0,0,1,0,0,0,1,0,0,0,0,0,0,0,0,0,0,0,0,0,0,0,1,0,0,0,0,7,0,0,7,0,0,0,0,0,0,0,0,1,0,1,0,0,0,2,0,1,2,1,0,0,0,0,0,0,0,0,2,0,0,0,0,14,0,0,0,2,0,0,1,0,1,0,0,0,0,1,0,0,0,0,0,0,0,0,0,0,0,0,0,0,0,0,0,0,9,0,1,0,0,0,0,1,0,0,0,0,2,0,0,0,18,0,0,0,0,0,0,0,0,0,0,0,0,0,0,0,0,0,0,0,0,0,1,4,1,0,0,0,1,0,0,0,0,3,0,0,0,0,1,5,0,0,0,0,0,0,0,6,0,0,0,0,0,0,0,0,2,0,0,0,0,0,0,1,0,0,0,0,6,0,0,0,0,9,0,0,0,0,0,0,0,0,0,0,0,0,0,0,0,0,5,0,0,0,0,0,0,0,0,0,0,0,0,1,0,0,0,0,0,0,0,0,0,0,0,0,0,0,0,0,0,0,0,0,0,0,0,0,0,0,0,0,0,0,0,0,0,0,0,0,0,0,0,0,0,0,0,0,0,0,0,0,0,0,0,0,0,0,0,0,0,0,0,0,0,0,0,0,0,0,0,0,0,0,1,0,0,0,0,0,0,0,0,0,0,0,0,0,0,0,0,0,0,0,0,0,0,0
"Colon Cancer",3755,1041,862,10817,510,2529,444,342,1884,528,444,1049,483,431,256,249,3537,1129,349,503,942,290,12073,994,180,107,591,8793,568,89,727,1270,216,41,182,350,213,152,780,137,11872,2459,343,410,211,1164,51,20,1580,963,38,45,186,1611,198,215,123,461,1969,487,4621,299,378,391,5456,273,1880,350,44,122,453,40,107,104,207,235,86,556,186,2004,649,2735,12579,861,1413,47,1271,105,59,175,76,2038,1645,57,909,40,198,81,67,1345,152,282,2129,45,93,226,378,99,66,4148,156,30,252,326,672,40,308,105,343,92,63,50,55,1412,136,286,3949,100,170,7530,112,816,924,129,300,1015,266,44,374,509,42,261,83,154,561,805,131,133,40,92,2979,45,456,177,227,160,727,1108,454,47,20,44,34,23,20,29,1855,244,80,92,817,33,72,362,137,41,129,116,162,37,32,2763,777,35,43,115,59,106,32,80,169,27,45,91,28,189,96,88,32,204,9,15,137,55,3,500,209,1195,24,2881,44,78,1666,220,36,520,1564,18,158,48,3902,36,25,41,29,52,87,1409,686,4488,203,662,142,12,26,73,57,1194,27,16,44,8,953,163,23,211,72,27,288,32,84,38,222,52,176,734,17,260,126,186,100,8,40,626,14296,159,473,420,361,40,95,378,90,53,9,8,1583,34,5,377,464,34,16,183,15,10,178,23,8,31,15,3,431,190,59,697,48,25,203,32,15,142,113,348,21,353,71,4,399,10,33,19,477,53,609,52,23,27,526,6,55,23,112,30,45,171,340,65,6,21,327,101,70,7,22,22,13,4,2,608,256,93,163,377,55,4,127,62,12,18,25,9,20,20,22,98,123,57,9,24,12,45,174,3,271,211,5,169,4,3,26,1319,26,269,36,26,18,14,32,71,70,72,62,46,25,17,71,78,102,102,36,800,0,22,10,96,199,3,448,298,983,77,20,27,214,6,30,103,331,14,23,18,28,401,118,19,7,67,236,14,77,66,68,58,6,29,26,61,10,26,4,61,97,73,8,3,5,28,5,35,88,6,9,22,3,185,23,135,4,5,16,123,277,122,2,0,2,24,86,17,106,20,4,78,8,198,1889,3,3,28,17,88,24,15,134,107,140,433,37,7,2,50,11,180,14,4,45,51,83,6,154,21,171,12,143,10,13,86,4,25,44,20,123,5,19,12,25,3,101,11,4,252,91,18,2,18,29,54,32,29,34,37,33,43,16,663,4,18,4,17,8,93,219,442,14,26,79,19,31,399,419,55,106,4,122,21,56,18,28,20,6,16,6,2,163,825,102,30,22,115,73,30,8,37,4,52,12,18,26,14,135,6,109,74,1,10,264,3,12,3,48,8,204,24,15,64,297,8,2,9,80,14,21,31,15,12,50,49,24,117,8,11,317,92,10,21,38,25,134,3,66,161,1,19,3,840,58,18,24,205,260,358,267,246,28,15,1,24,2,39,464,1,528,57,154,9,13,19,15,24,165,5,27,29,324,480,7,2,75,60,9,25,12,10,0,1022,3,34,26,0,1,47,13,8,29,164,3,8,19,1450,23,11,6,7,364,3,146,4,109,15,29,15,10522,70,239,14,13,390,50,13,153,144,350,0,40,3,32,18,12,23,124,22,32,11,7,0,23,4,3,6,18,6,91,104,35,211,89,0,0,75,37,42,245,10,68,27,16,0,1,9,19,405,179,11,8,140,98,4,3,71,26,6,4,48,7,4,296,3,9,9,12465,21,605,4,8,658,0,7,14,21,5,138,4,78,45,811,85,28,112,46,9,7,5,3,42,12,131,16,1841,28,5,175,6,7,74,2,7,5,10,104,2,2,299,12,119,3,1,6,13,79,8,10,3,26,12,8,2,9,6,52,121,5,24,1,51,0,11,190,6,12,4,5,17,18,5,39,9,2,1,29,2,80,8,4,25,476,28,25,9,5,36,0,7,137,4,17,6,1,0,1,428,71,5,72,14,203,3,269,3,3,1,115,15,28,97,7,2,10,16,52,0,100,1,8,2,22,43,4,5,24,3,15,93,20,4,0,6,1,0,2,344,5,6,17,49,734,24,71,13,113,3,10,31,5,5,5,13,13,38,0,5,1,3,98,68,18,55,1,438,11,0,3,2766,2,9,11,17,3,101,77,4,76,25,4,33,3,16,1,3,12,2,213,70,435,0,32,49,4,535,4,59,4,702,32,6,0,9,2,11,4796,131,5,68,3446,109,0,325,1,9,5,5,8,7,23,3,17,83,131,33,5,0,4,0,141,8,63,21,1,27,4,7,20,310,4,51,3,16,0,39,6,19,8,114,9,4,8,89,31,7,1,20,38,2,253,1,48,8,4,9,0,52,22,8,10,1,42,25,33,16,0,3,3,23,87,3,43,58,72,2,3,0,5,0,8,28,110,2,9,19,32,15,3,4,5,2,0,33,2,55,25,4,0,169,5,0,2,0,0,59,73,3,1,21,2,8,0,332,53,2939,3,12,14,5,96,19,1,6,0,2,0,0,64,132,0,29,12,14,8,7,37,1214,18,9,1,1,12,25,1,73,0,0,7,1,7,14,2,11,5,109,3,0,39,80,9,2,0,4,29,2,4,2,204,5,22,1,15,2,2,25,3,7,10,131,0,5,3,1,8,47,6,1,671,47,19,182,0,12,33,4,3,2,11,51,22,3,4,9,49,16,9,0,0,7,80,2,15,4,10,212,23,10,0,73,34,994,2,30,1,74,0,2,20,52,1,477,1,0,44,8,1,1,3,20,49,33,37,2,7,3,6,10,3,60,7,0,3,19,36,6,16,0,0,45,2,2,92,122,26,15,2,91,11,75,20,27,3,124,7,1,11,6,0,7,193,243,22,11,4,306,1,78,4,0,12,74,4,0,24,2,62,3,2,16,0,4,21,0,23,109,25,5,4,3,0,2,4,91,5,13,21,9,1,0,22,2,67,0,349,3,2,45,11,0,80,211,1,26,1,2,6,13,107,2,8,22,4,1,5,3,5,23,0,11,9,148,32,1,0,9,0,26,5,10,5,12,109,2,29,3,21,9,26,20,6,7,49,1,0,13,0,27,127,25,79,277,55,0,11,6,15,16,0,1,1,4,4,12,0,1,0,197,2,55,6,46,18,13,6,41,2,1,70,1,1,3,6,7,16,1,1,0,0,3,31,2,23,1,119,92,2,2,2,38,88,56,19,9,13,62,4,4,4,3,11,0,0,0,12,3,11,19,24,3,2,15,0,3,1,20,30,6,39,2,7,43,8,4,9,134,9,14,2,7,0,3,3,69,0,0,0,15,4,4,3,1,3,32,225,5,10,2,1,1,16,24,11,4,10,0,39,0,0,2,1,22,11,11,92,1,127,6,0,0,44,3,7,1,6,1,1,0,3,7,52,40,0,23,0,1,34,11,19,40,49,0,8,8,1,3,4,82,24,9,1,8,3,10,3,1,0,0,0,31,0,3,26,65,25,11,1,2,19,3,105,1,1,19,0,20,13,1,23,0,4,0,1,6,4,11,9,17,0,3,2,1,8,3,12,3,38,2,11,0,5,6,14,2,4,0,47,2,2,124,0,86,7,1,1,59,99,24,0,108,39,1,0,0,4,1,47,14,2,29,18,14,35,2,3,0,23,1,12,38,2,0,4,15,0,1,33,1,34,2,0,8,3,6,21,3,67,17,35,6,2,15,233,2,0,1,3,0,0,0,24,0,7,147,1,15,3,1,323,11,9,6,32,14,1,2,1,0,0,6,0,1,1068,0,2,0,5,19,8,3,5,3,19,1,3,6,5,1,0,46,1056,30,24,55,256,3,3,61,3,4,7,26,4,98,0,1,140,2,0,0,18,18,1,4,11,14,6,0,0,7,2,1,25,1,204,1,1,1,22,4,23,254,5,0,2,4,0,26,1,128,1,0,1,6,3,20,3,0,4,15,0,0,23,0,3,3,1,1,0,34,3,4,2,67,0,19,0,3,6,0,3,11,28,0,8,556,9,13,56,4,387,0,10,3,3,2,0,8,2,3,0,6,0,4,0,7,1,5,0,1,1,0,64,2,0,14,35,4,0,1,5,2,0,6,5,0,3,1,2,2,0,31,5,1,0,5,64,7,8,7,1,2,0,27,7,0,0,12,3,0,0,7,3,0,0,1,1,0,1,3,0,1,2,3,9,0,2,3,4,11,6,1,9,5,3,0,16,0,1,0,46,7,21,3,2,5,24,0,10,5,0,1,3,1,2,125,24,19,32,3,3,5,3,5,31,0,1,17,1,15,13,43,2,3,5,1,3,0,3,251,2,18,43,5,110,16,20,2,6,1,704,1,1,0,4,11,2,0,0,0,12,0,12,1,0,13,1,1,58,12,1,1,35,5,7,10,2,59,2,62,1,7,1,2,6,0,0,5,13,27,18,17,1,5,11,24,3,4,3,0,2,1,0,0,10,0,7,1,0,5,0,20,0,3,2,0,3,2,0,6,12,20,3,0,0,7,4,0,0,1,0,46,1,1,3,3,9,0,0,0,1,0,4,16,19,42,1,2,6,1,5,6,0,7,4,0,14,2,1,1,4,20,0,0,5,20,0,8,14,26,0,0,0,6,14,0,0,0,90,14,0,0,0,5,4,17,5,0,2,0,2,6,1,0,2,2,1,43,1,4,7,4,5,2,8,1,2,21,0,0,35,0,0,0,0,0,50,5,1,21,15,0,0,6,0,0,0,0,47,0,208,9,3,1,1,10,1,18,0,0,1,1,10,2,7,0,2,15,0,3,2,11,182,16,0,0,0,1,35,156,4,0,1,72,4,0,1,71,2,0,10,0,17,0,2,1,4,0,6,79,0,1,0,0,0,3,1,2,29,3,7,5,72,1,2,6,7,0,4,0,0,2,2,1,2,3,9,4,0,0,1,3,0,1,0,5,0,2,0,2,0,22,2,0,11,2,0,28,0,2,22,15,10,15,0,1,5,3,1,14,1,6,0,1,0,3,0,31,13,12,5,0,39,2,0,0,1,37,0,0,6,80,1,323,0,4,1,0,17,3,47,1,4,12,5,2,0,0,0,8,0,0,10,0,24,1,2,10,2,8,1126,2,2,0,0,4,3,1,2,2,0,1,0,2,1,0,13,0,6,1,134,9,0,10,45,0,2,2,1,0,0,0,2,0,0,97,6,0,0,169,0,1,4,0,44,3,0,4,0,0,31,0,2,1,0,0,0,4,8,5,4,9,1,4,2,0,3,0,25,4,1,1,0,0,0,0,24,3,1,9,1,0,1,30,2,4,32,0,1,2,1,9,0,1,10,26,1,0,1,0,46,0,1,34,4,0,0,0,11,8,6,0,7,0,100,2,0,4,0,0,1,1,8,0,3,3,0,0,3,3,1,2,0,3,15,2,12,0,2,1,0,4,3,1,0,0,1,1,0,18,8,88,0,4,8,0,10,0,0,1,11,1,8,0,1,2,50,0,1,0,2,1,2,1,1,19,7,0,0,0,14,0,0,30,13,0,0,3,0,0,1,0,1,1,3,14,0,0,2,11,14,2,0,250,3,103,0,1,2,12,3,2,0,6,0,0,5,0,22,0,0,10,0,0,1,0,3,2,0,14,12,17,0,0,14,17,0,24,5,25,1,7,0,1,2,1,9,1,2,1,2,0,14,2,1,6,4,0,0,0,6,3,1,1,1,0,33,4,0,1,1,0,0,0,18,1,9,1,65,10,1,0,19,0,1,3,0,4,24,11,2,25,0,119,0,1,3,1,16,0,1,0,0,0,8,1,0,0,5,2,3,1,1,1,1,4,2,7,0,0,32,9,5,76,10,0,13,0,76,2,138,0,0,0,11,0,0,1,7,0,0,0,17,0,0,7,11,0,1,3,0,0,1,1,3,0,2,0,1,38,0,0,0,0,0,3,3,0,2,37,10,0,0,1,0,1,0,0,2,10,14,15,4,1,2,0,0,0,0,1,3,0,0,1,1,3,0,4,4,1,0,2,1,1,0,0,0,2,0,0,1,0,1418,0,1,0,5,0,2,5,6,0,1,0,4,3,0,0,0,0,0,2,0,27,6,8,1,3,1,60,2,5,3,0,3,0,1,2,19,2,2,3,0,2,8,31,1,7,0,0,0,4,6,1,2,0,0,0,0,0,0,0,2,0,4,0,24,4,0,0,1,0,9,5,8,2,0,0,1,0,1,0,1,2,1,0,0,5,0,0,0,2,0,0,0,0,2,0,13,1,0,1,6,0,0,11,0,48,0,3,0,10,0,1,2,0,1,1,0,0,6,0,2,0,2,3,0,14,1,0,3,1,0,0,0,21,16,4,5,2,7,0,2,1,3,0,0,0,0,0,0,0,0,0,0,2,0,4,0,1,1,0,0,0,0,4,1,0,0,0,0,0,0,0,0,0,0,0,2,7,5,0,0,0,0,0,0,4,3,0,0,1,0,0,8,0,1,0,0,0,0,22,1,0,8,0,4,99,0,0,0,0,0,0,2,0,73,0,1,0,0,0,1,6,3,0,0,11,10,0,0,1,0,1,3,1,0,1,0,2,0,4,0,0,0,4,0,11,0,6,2,3,0,7,1,0,1,72,1,2,3,0,0,3,0,0,0,33,0,1,0,3,0,13,0,8,0,0,1,0,0,0,1,2,2,0,0,4,0,0,1,0,0,0,0,3,5,3,7,1,0,71,0,0,1,0,2,0,1,0,0,1,0,0,0,2,0,0,0,1,0,0,12,4,1,1,3,1,0,0,1,0,0,1,0,3,0,0,0,1,0,0,0,0,0,1,0,1,0,70,0,0,2,0,1,1,8,0,0,8,0,3,0,0,0,3,5,0,0,4,3,2,6,6,2,1,0,0,6,2,10,3,0,1,1,1,0,0,1,0,1,0,30,0,1,40,3,1,0,1,3,0,1,24,0,1,1,1,10,0,1,0,26,0,1,0,0,0,22,1,0,0,0,1,0,0,1,0,2,2,4,0,0,0,0,0,1,1,3,2,1,0,1,0,32,0,0,2,1,3,0,0,2,0,1,0,0,1,0,6,0,4,0,0,2,6,0,0,1,0,0,1,10,7,0,1,14,3,5,1,2,0,1,0,0,79,0,0,1,0,0,0,1,0,0,5,0,33,3,0,0,1,0,0,7,1,0,1,0,0,0,0,2,0,1,0,3,0,0,0,0,1,0,0,0,4,5,0,0,0,0,0,0,0,8,0,5,2,1,0,0,1,12,0,4,1,0,0,0,3,2,0,0,1,0,0,0,0,0,0,2,8,8,1,0,2,2,0,17,2,0,2,0,0,5,0,0,10,0,0,4,1,0,0,1,0,4,2,0,0,0,8,0,0,0,0,0,1,8,0,0,0,0,30,11,1,1,1,1,1,1,0,1,0,0,0,0,2,0,0,5,0,8,1,0,0,1,0,1,0,0,0,1,10,0,0,0,0,0,1,0,3,0,0,2,2,206,0,0,3,1,5,0,0,1,0,0,3,0,0,0,2,0,1,2,0,0,0,0,1,0,0,0,6,0,0,0,0,74,0,0,12,0,0,0,0,0,0,0,2,3,1,4,6,0,1,2,1,0,0,0,2,0,8,4,3,1,0,9,0,0,3,0,0,0,0,0,0,1,0,0,0,1,0,0,0,0,3,0,0,0,1,0,1,0,0,1,0,0,0,1,0,0,0,1,0,0,1,2,2,1,0,1,0,1,0,0,97,3,3,6,0,2,1,0,0,9,1,0,0,0,0,0,1,0,3,0,0,5,0,4,0,5,3,0,1,0,9,0,0,0,0,0,0,0,0,1,1,0,2,1,0,0,0,7,0,1,0,0,0,0,0,0,0,0,0,0,0,3,0,0,0,0,0,7,0,1,1,0,0,0,0,0,0,0,0,5,0,2,0,1,0,11,0,0,131,2,0,0,0,0,0,0,0,2,0,0,2,2,31,0,1,0,0,1,0,1,0,1,0,0,20,0,0,3,2,0,0,0,0,0,2,0,0,0,1,0,0,0,0,1,0,1,0,2,0,1,0,0,7,0,2,0,0,2,0,0,0,1,0,0,2,0,0,2,16,0,0,0,0,0,2,2,0,0,1,0,4,1,0,1,5,0,41,3,1,0,11,0,1,1,0,4,0,2,0,0,0,0,0,0,0,3,5,0,0,0,2,0,8,0,0,2,0,0,0,0,0,0,1,0,1,0,0,0,0,1,0,0,1,1,1,1,0,0,0,2,0,0,0,6,0,0,1,0,0,0,0,0,1,0,0,0,0,1,11,2,2,0,0,0,0,0,0,0,7,0,1,1,0,12,1,0,0,1,0,0,1,2,0,0,0,0,0,0,0,1,0,1,0,0,0,0,0,1,0,0,0,0,0,0,0,0,0,0,0,0,0,2,1,1,0,0,1,0,0,0,0,0,0,1,0,0,0,0,2,2,0,1,0,1,0,0,0,0,0,0,0,0,1,0,0,0,0,0,1,1,0,4,0,1,0,0,0,0,0,0,37,0,0,0,0,0,0,0,0,0,1,0,0,0,0,0,1,0,1,0,0,2,0,1,0,0,0,0,0,2,0,0,0,0,0,0,0,0,3,0,0,0,0,0,0,4,0,0,0,0,0,0,0,0,2,0,2,0,0,0,0,0,0,0,0,0,0,0,0,0,0,0,0,0,0,0,0,0,0,1,0,0,3,7,0,0,0,0,1,0,0,0,1,8,0,1,0,0,0,0,1,10,0,0,0,0,2,1,0,0,1,0,0,1,0,0,0,0,0,0,0,0,0,0,0,0,0,1,0,0,0,0,0,0,0,0,0,0,0,0,1,0,0,0,2,0,0,0,0,0,0,0,0,0,0,0,0,1,0,0,0,0,0,0,0,0,0,0,0,1,0,1,0,0,0,0,0,0,0,0,1,0,0,0,0,0,0,0,0,0,0,3,0,0,0,0,0,0,20,0,0,0,1,0,0,0,0,0,0,0,0,0,0,0,0,2,0,0,0,0,0,0,0,0,0,0,0,0,0,4,1,0,0,0,0,0,0,0,0,0,0,0,0,0,0,0,0,0,0,0,0,0
"Endometrioid Cancer",109,65,81,1461,1,113,10,8,245,8,5,49,4,3,5,3,45,137,6,1,28,1,992,120,1,2,24,5,21,3,15,55,2,1,5,4,4,3,6,0,624,409,13,20,11,46,1,0,125,0,1,1,1,27,1,1,1,3,159,297,45,35,1,27,734,14,34,35,2,2,1,1,2,1,4,6,0,30,0,19,5,307,219,29,825,4,14,4,0,2,2,9,14,2,9,0,17,104,0,16,1,10,103,0,2,15,11,7,1,584,0,1,7,20,10,1,13,0,3,3,2,1,0,30,0,11,647,0,2,1,1,21,16,1,2,6,4,4,4,0,0,15,1,5,3,7,3,8,0,1,242,2,29,0,6,7,6,15,2,2,0,1,0,0,0,0,233,0,6,1,28,1,1,1,1,2,3,0,3,1,0,120,47,0,0,2,98,2,2,3,12,0,0,1,0,5,3,0,3,9,0,0,0,2,2,1,8,45,1,111,0,1,93,2,0,1,3,0,6,2,10,0,1,1,2,3,1,62,7,0,1,68,0,0,4,0,1,254,3,0,1,0,59,3,0,7,3,3,0,3,3,1,0,0,29,7,0,22,1,10,4,0,2,133,115,0,19,3,42,2,3,3,1,2,1,0,1,0,3,2,2,3,0,2,0,0,10,0,2,2,1,0,68,2,0,5,1,0,27,0,14,1,2,4,0,4,1,0,8,0,1,0,9,0,6,4,0,0,596,0,0,0,1,0,1,1,0,0,2,1,0,0,1,1,0,0,0,0,0,2,4,6,5,5,4,1,1,1,0,1,0,0,0,0,0,0,0,3,1,2,0,0,0,2,3,17,0,10,1,0,3,218,0,15,0,0,2,0,0,1,5,0,0,0,0,0,0,68,1,0,1,11,0,0,0,1,0,0,972,0,3,0,0,0,1,0,0,116,4,0,0,0,0,45,0,1,0,19,95,0,2,1,3,0,0,0,1,1,0,0,0,0,9,0,0,0,0,0,0,0,0,0,0,0,0,0,20,0,0,1,1,18,34,15,0,0,0,0,255,4,3,0,0,0,0,18,206,0,0,2,1,0,1,0,0,1,0,5,1,0,0,1,0,8,0,0,0,70,0,0,79,0,15,0,16,0,0,1,1,0,2,0,8,0,0,0,0,0,1,0,1,60,3,0,0,0,1,1,0,1,0,0,0,1,2,160,1,0,0,1,0,1,25,3,0,3,1,0,0,17,106,0,5,0,1,1,5,1,2,0,0,0,0,0,5,0,0,0,0,0,5,1,0,1,0,8,0,0,0,1,0,0,13,2,0,0,31,0,0,1,0,0,0,4,1,2,4,0,0,0,0,0,0,0,0,0,0,2,0,0,2,31,3,1,0,0,1,0,0,0,1,0,0,0,0,1,0,0,0,0,25,0,9,32,0,2,0,9,0,0,409,0,98,0,1,0,0,0,1,0,7,0,2,1,24,3,1,0,0,13,0,0,0,0,0,3,0,0,0,0,2,47,0,1,3,2,0,0,1,2,1,0,0,0,4,0,2,0,2,1,0,0,4,2,5,0,4,4,2,0,2,2,5,0,1,0,1,0,0,18,8,0,0,0,0,0,2,0,0,1,0,0,5,0,0,11,1,0,0,1,0,0,0,0,0,1,0,0,0,0,1,3,5,0,0,1,0,0,0,16,0,1,0,0,0,0,2,0,2,0,3,0,34,1,2,1,0,0,0,1,0,1,0,5,0,10,1,36,8,2,0,0,0,0,0,0,25,0,982,1,0,17,0,0,0,0,0,0,0,23,1,0,44,0,0,0,0,0,0,0,0,0,1,2,6,0,1,0,0,1,0,0,0,0,0,0,0,9,0,0,1,1,0,1,0,1,1,0,0,0,0,9,0,0,3,14,5,0,0,0,0,0,0,31,0,1,2,0,0,0,0,1,0,0,0,0,0,1229,0,0,0,3,0,0,13,1,0,0,0,2,0,0,0,0,0,2,4,0,0,0,0,1,0,0,1,0,0,1,0,0,44,0,0,0,0,3,1,5,0,0,0,0,0,0,0,1,0,1,0,1,0,0,1,2,1,0,1,0,0,0,0,0,339,0,0,0,0,0,4,21,0,3,5,0,0,0,0,0,0,1,0,9,1,8,0,0,2,0,30,0,3,0,1,0,0,0,2,0,0,12,0,0,0,9,12,0,0,0,0,0,0,0,0,0,0,0,1,8,2,3,0,0,0,0,0,0,1,0,0,0,0,0,1,0,0,1,1,0,0,0,0,0,0,0,0,0,7,0,0,0,4,1,0,4,0,5,0,1,0,0,1,0,10,0,0,0,0,0,0,0,0,0,0,0,0,3,0,13,0,0,0,0,0,0,1,0,0,0,1,0,0,0,0,0,0,0,1,0,12,0,0,0,5,0,0,0,0,0,3,1,0,1,1,0,0,0,5,0,19,0,0,0,0,23,0,0,0,0,0,0,0,4,17,0,0,0,0,0,0,0,1,0,0,0,0,0,0,0,0,0,0,0,0,0,2,0,0,0,0,0,0,2,8,1,0,0,0,0,0,0,0,1059,0,1,0,0,0,0,0,0,0,0,2,0,0,0,0,0,0,0,0,149,0,0,0,0,2,10,0,0,1,1,0,0,0,0,0,1,0,0,0,0,0,2,1,0,1,0,0,0,0,0,1,1,2,0,4,0,2,0,0,1,14,0,3,0,0,1,1,0,0,1,0,0,0,1,0,0,0,0,0,0,0,0,0,0,0,0,0,0,0,0,0,0,0,7,7,1,20,0,0,0,0,1,0,0,2,1,0,1,0,0,1,165,0,0,2,0,0,0,0,0,0,0,4,0,0,2,0,0,0,0,1,0,0,0,0,1,1,0,0,0,1,0,0,0,0,2,0,0,0,1,0,0,0,0,0,1288,0,1,5,0,0,0,9,0,0,0,0,0,0,385,0,2,0,1,0,0,0,0,1,0,0,0,0,0,0,0,0,0,0,0,0,0,12,1,0,1,0,2,0,1,0,0,0,0,0,1,0,0,0,3,0,1,0,764,0,0,0,0,0,0,0,0,0,2,2,0,0,0,0,0,11,6,0,0,0,0,2,0,0,46,0,0,0,1,1,1,0,1,0,0,0,1,0,17,0,6641,1,0,1,0,2,0,2,0,0,0,8,0,12,0,0,0,0,0,0,0,0,1,1,0,0,0,0,0,0,0,0,19,0,3,0,1,0,0,0,0,6,0,0,0,23,0,0,0,14,0,0,0,0,1,0,5,0,0,0,1,0,0,0,0,0,0,16,0,0,0,0,0,0,0,0,0,0,0,0,1,0,26,0,0,0,24,0,0,0,0,0,0,0,0,2,0,0,0,2,0,0,2,0,1,0,19,0,0,0,0,0,1,0,0,0,0,0,0,0,0,0,0,0,0,0,0,0,1,0,0,0,0,0,0,0,986,0,0,1,0,1,0,0,1,0,0,0,0,0,0,0,0,0,0,0,0,0,0,0,8,0,2,0,0,0,0,0,3,0,0,0,0,0,0,2,0,0,0,0,0,0,0,1,0,13,0,0,0,0,0,0,0,0,1,5,0,0,0,8,0,0,0,0,0,0,0,0,0,0,0,0,0,0,3,0,0,0,0,0,0,0,1,0,2,0,0,0,4,0,0,0,0,0,0,0,1,0,0,0,0,0,1,0,0,0,0,0,4,0,0,0,0,0,0,1,0,0,0,0,0,0,0,0,0,0,0,0,1,0,0,0,1,0,0,0,1,1,0,0,3,0,0,1,0,0,0,0,0,204,0,0,0,0,0,0,2,0,0,0,0,0,0,1,0,0,0,0,0,2,0,0,0,0,1,0,0,3,0,0,0,0,0,0,0,2,0,0,0,0,0,1,0,0,0,0,0,0,0,0,0,0,0,0,0,2,0,0,0,0,0,0,0,0,0,0,0,1,6,0,0,34,1,0,1,6,19,0,0,0,0,0,0,0,1,0,0,0,0,0,0,0,0,0,0,0,0,0,0,0,0,0,2,0,0,0,0,0,0,0,0,0,0,0,0,0,0,1,0,0,0,1,0,0,0,0,0,0,0,0,0,0,0,0,0,0,0,0,0,0,0,0,0,0,0,0,0,0,0,0,0,0,0,0,0,0,0,0,1,0,0,0,0,0,0,0,0,0,1,0,0,0,52,0,0,0,0,0,0,0,0,123,2,0,0,0,0,1,0,0,90,0,0,0,0,0,0,0,0,0,0,0,2,0,0,0,0,0,0,0,0,1,0,0,0,0,0,0,0,0,0,0,2,0,0,0,0,0,63,0,0,1,0,0,1,0,0,0,1,0,0,0,0,0,0,0,0,1,0,1,0,0,0,0,1,2,0,1,0,0,0,0,1,0,0,0,0,1,0,0,106,0,0,0,0,1,0,0,0,0,0,0,1,0,0,0,1,0,0,0,0,0,0,0,0,0,0,0,0,0,1,0,0,0,0,0,0,0,0,0,0,0,0,0,0,0,0,0,0,0,0,0,0,0,0,0,0,0,0,0,1,0,0,0,0,0,0,0,0,15,0,0,0,1,0,1,0,0,0,1,0,0,0,0,0,0,0,0,0,0,0,0,0,13,0,0,0,0,0,0,0,0,0,0,0,0,16,0,0,0,0,0,0,0,0,5,0,0,0,0,0,0,1,0,0,0,1,1,0,0,0,0,0,1,0,0,0,0,1,0,0,0,0,0,0,0,0,0,116,1,0,0,0,0,0,0,0,0,0,0,0,0,0,0,0,0,1,0,0,0,0,0,0,0,0,129,0,0,0,0,0,0,0,0,0,0,0,0,0,0,0,0,1,0,0,0,0,0,0,0,2,1,0,0,0,0,0,7,0,0,0,0,0,0,0,0,0,0,1,0,2,0,0,0,0,0,0,70,0,0,0,0,0,0,0,0,0,0,0,0,2,0,0,4,0,1,0,0,13,0,0,0,1,5,0,0,2,489,0,16,0,0,0,1,2,1,1,0,0,0,0,0,0,0,0,0,0,0,1,0,0,0,0,0,0,0,1,0,0,0,0,0,0,0,0,0,0,0,0,0,0,0,0,0,0,0,0,10,0,1,3,0,0,0,0,0,0,0,0,0,0,2,0,0,0,0,0,0,1,0,0,0,0,6,0,0,3,0,0,0,0,0,0,0,0,0,0,1,0,0,0,0,0,0,0,1,0,0,0,0,0,0,75,0,0,1,0,0,0,0,0,0,0,0,1,0,0,0,0,0,0,0,0,0,0,0,0,0,0,56,0,0,0,0,1,3,0,0,0,0,1,0,0,0,0,0,0,0,0,0,0,0,0,0,0,0,1,0,0,0,62,0,0,0,0,0,0,0,0,0,0,0,0,0,0,10,1,0,0,0,0,0,0,0,0,0,0,0,0,0,1,0,1,0,0,0,1,0,0,0,0,138,0,0,0,0,2,0,0,0,0,0,0,0,0,0,0,0,0,0,0,0,0,0,0,0,2,0,0,1,0,3,0,0,0,0,0,0,0,0,0,0,0,0,0,0,0,0,0,0,0,0,0,0,0,4,0,0,0,0,1,0,0,0,0,0,3,5,0,0,0,0,0,0,0,0,0,0,1,0,0,0,0,0,0,0,0,0,0,0,0,0,218,0,0,0,0,0,0,0,0,0,1,0,0,0,0,0,0,0,0,0,0,0,5,0,0,0,0,12,0,1,0,0,1,0,0,0,0,0,3,0,0,0,0,0,0,0,0,0,0,0,0,0,0,0,0,1,0,23,1,0,0,0,0,0,3,0,0,0,0,0,0,0,0,0,0,0,2,0,0,0,0,0,0,5,0,0,0,3,0,0,0,0,0,0,0,0,0,0,0,0,0,0,0,33,0,0,0,0,0,0,0,0,0,3,0,50,0,0,0,0,0,0,0,0,0,0,0,0,0,0,0,0,0,0,0,0,0,0,0,0,0,0,0,0,0,0,0,0,0,0,0,0,0,0,4,0,0,0,0,0,0,0,0,0,0,0,0,66,0,0,0,0,0,3,0,0,0,0,0,0,0,1,1,0,0,0,0,0,0,2,0,0,0,0,0,0,0,0,1,0,0,0,0,0,0,0,0,0,0,2,0,0,0,0,0,0,0,0,0,3,0,0,0,0,0,0,0,0,0,0,0,0,0,0,0,0,0,0,0,0,0,1,0,0,0,0,1,0,0,0,0,0,0,0,0,0,0,0,0,0,0,0,0,0,0,0,0,0,0,0,0,0,0,0,0,0,0,0,0,0,0,0,0,0,1,0,0,0,0,0,0,0,0,0,0,0,0,0,0,0,0,0,0,0,0,0,0,0,0,0,0,0,0,0,0,0,0,0,0,0,0,0,0,0,0,0,0,0,0,0,0,0,0,0,0,0,0,0,0,0,0,0,0,0,0,1,0,0,0,0,0,0,0,0,0,0,0,0,0,0,1,0,0,0,0,0,0,0,0,0,0,0,0,0,0,0,0,0,4,0,0,0,0,1,0,0,0,0,0,8,0,0,0,3,0,0,0,0,0,1,0,27,0,0,0,0,0,0,0,0,0,0,0,0,0,0,0,0,0,7,0,0,0,0,0,0,0,0,0,0,0,0,0,0,0,0,0,0,0,0,0,0,0,0,0,0,0,0,0,0,0,0,0,0,0,0,0,0,0,0,0,0,0,0,0,0,0,0,0,0,0,0,0,0,0,0,0,0,0,0,0,0,0,0,0,0,0,0,0,0,0,0,0,0,0,0,0,0,0,0,0,0,0,0,0,0,0,0,0,14,4,1,0,0,0,0,1,0,0,0,0,0,0,0,0,0,1,0,0,0,0,0,0,1,0,0,0,0,0,0,0,0,0,0,0,0,0,0,0,0,0,0,6,0,0,0,140,0,0,0,0,0,7,0,0,0,1,0,0,0,0,0,0,0,2,0,0,0,0,0,0,0,0,0,0,0,0,0,0,0,0,0,0,0,0,0,0,0,0,0,0,0,0,0,0,0,0,0,0,1,0,0,0,0,0,0,0,0,0,0,0,0,1,0,0,0,0,0,0,2,0,0,0,0,0,0,0,0,0,0,0,0,0,0,0,0,0,0,0,0,0,0,0,0,0,0,0,0,3,0,0,0,0,0,0,0,0,0,0,0,2,0,0,0,0,0,0,0,58,3,5,0,0,0,0,0,0,0,0,0,0,0,0,0,0,0,0,0,0,0,0,0,0,0,0,0,0,0,0,0,0,0,4,1,0,0,0,0,0,0,0,1,0,0,0,0,0,0,0,0,0,0,0,0,0,4,0,0,0,0,0,5,11,0,0,0,4,0,0,0,0,0,0,0,0,0,0,0,0,0,0,0,0,0,0,0,0,0,0,0,0,0,0,0,0,0,0,0,0,0,0,0,0,0,0,0,0,0,0,0,42,0,0,0,0,0,0,0,0,0,0,0,0,0,0,1,0,0,0,0,0,0,0,0,0,0,0,0,0,0,0,0,20,0,0,0,0,0,0,0,0,0,0,0,0,0,0,0,0,0,0,4,0,0,0,0,0,0,0,0,0,0,41,0,0,0,0,0,0,0,0,0,0,0,0,0,0,0,0,0,0,0,0,0,0,0,0,0,0,0,0,0,0,0,3,0,0,0,0,0,0,0,0,0,0,0,0,0,0,0,0,0,0,0,4,0,0,0,0,0,0,0,0,0,0,0,0,0,4,0,0,0,0,0,3,0,1,3,0,0,0,0,0,0,0,0,0,0,0,0,0,0,0,0,0,0,0,0,0,0,0,0,2,0,0,0,0,0,0,0,0,0,0,0,0,0,0,0,0,0,0,0,0,0,0,0,0,0,0,0,0,0,0,0,0,0,0,0,0,0,0,0,0,0,0,0,0,0,0,0,0,0,0,0,0,0,0,0,0,0,0,0,0,0,0,0,0,0,0,0,0,0,0,0,0,0,0,0,0,0,0,0,0,0,0,0,0,0,0,0,0,0,0,0,0,0,0,0,1,0,0,0,1,0,0,1,0,0,0,2,0,0,0,0,0,0,0,0,0,0,0,0,0,0,0,4,0,0,0,0,0,0,0,0,0,0,0,0,0,0,0,0,0,0,0,0,0,49,0,0,0,0,0,0,0,0,0,0,0,0,0,0,0,0,0,0,0,0,0,0,0,0,0,0,0,0,0,0,0,0,0,0,0,0,0,0,0,0,0,0,0,0,0,0,0,0,0,0,0,2,1,0,0,0,0,0,0,0,0,0,0,0,0,0,4,0,0,0,0,0,0,0,0,0,0,0,0,0,0,0,0,0,0,0,0,0,0,0,0,0,0,0,0,0,0,0,0,0,0,0,0,0,0,0,0,0,0,0,0,0,0,0,0,0,0,0,0,0,0,0,0,0,0,0,0,0,0,0,0,0,0,0,0,0,0,0,0,0,0,0,0,0,0,0,0,0,0,0,0,0,0,3,0,0,0,0,1,1,0,0,0,0,0,0,0,0,0,0,0,0,0,0,0,0,0,0,0,0,0,0,0,0,0,0,0,0,0,0,0,0,0,0,0,0,0,0,0,0,0,0,0,4,0,0,0,0,0,0,0,0,0,0,0,0,0,0,0,0,0,0,0,0,0,0,0,0,0,0,3,0,0,0,0,0,0,0,0,0,0,0,0,0,0,0,24,0,0,0,0,0,0,0,0,0,0,0,0,1,0,0,0,3,0,0,0,0,0,0,0,0,0,0,0,0,0,0,0,0,0,0,0,0,0,0,0,0,0,0,0,0,0,0,0,0,0,0,0,0,0,0,0,0,0,0,0,0,0,0,0,0,0,0,0,0,0,0,0,0,0,0,0,0,0,0,0,0,0,0,0,0,0,0,0,0,0,0,0,0,0,0,0,0,0,0,0,0,0,0,0,0,0,0,0,0,0,0,0,0,0,0,0,0,0,0,0,0,0,0,0,0,0,0,0,0,0,0,0,0,0,0,0,0,0,0,0,0,0,0,0,0,0,0,0,0,0,0,0,0,0,0,0,0,0
"Esophageal Cancer",1096,271,758,6351,225,1989,242,176,846,1394,100,1152,168,237,117,184,1435,541,254,428,393,172,7435,474,28,110,345,2055,319,163,366,571,117,83,99,240,94,98,360,50,3909,1153,212,63,94,351,33,69,240,1402,19,43,32,1122,189,49,153,575,1043,307,1180,355,165,100,2926,98,1406,289,23,69,909,27,31,199,101,133,10,398,64,484,149,2885,516,500,608,16,473,33,3,53,359,652,2303,24,228,23,271,11,13,502,154,179,309,8,20,59,119,33,168,4803,160,35,84,100,907,17,96,145,101,55,103,14,24,1180,136,171,2670,73,382,137,266,783,321,336,77,281,84,25,84,1289,8,119,53,126,226,245,18,52,10,14,912,45,295,76,50,35,849,939,352,27,10,16,26,15,23,18,2146,113,65,47,563,25,310,204,143,15,67,94,72,30,7,1177,839,9,45,86,5,14,30,27,336,22,55,95,21,37,223,40,19,121,6,10,30,5,9,122,135,445,4,1043,118,20,1121,59,21,146,1219,21,27,22,243,31,16,151,21,36,104,322,176,90,306,297,26,0,6,27,19,1206,28,1,32,5,719,69,25,74,15,9,92,31,72,60,43,22,66,103,1,175,16,54,57,8,54,323,666,0,446,265,167,39,55,40,13,13,5,1,63,25,1,1303,71,11,29,103,14,25,52,14,2,15,8,1,133,26,8,106,24,7,106,40,7,78,69,191,3,195,20,6,297,6,11,7,137,76,215,26,220,16,252,1,23,11,38,202,14,53,103,8,1,14,670,136,91,17,15,8,16,13,0,27,221,96,41,108,90,5,19,17,10,6,13,3,5,1,5,2735,1424,16,4,11,6,6,22,4,381,305,6,67,6,0,7,1210,58,25,12,27,17,4,65,52,54,17,124,36,27,6,27,88,3,22,10,67,1,7,3,128,334,10,12,563,1298,60,6,5,116,1,9,8,156,11,5,3,15,420,74,1,11,98,8,9,25,132,217,10,1,4,5,48,16,3,0,145,9,5,21,11,14,13,5,21,25,9,4,73,4,179,0,17,6,1,21,39,59,78,11,0,0,6,5,11,96,20,17,4,6,75,283,0,3,9,14,31,4,10,126,17,14,23,39,0,5,17,7,146,5,3,83,7,30,2,64,27,119,4,155,1,8,64,3,13,6,27,78,2,36,4,10,4,57,11,12,1078,48,4,1,12,91,20,3,89,3,12,10,12,6,585,4,38,3,69,9,26,479,24226,9,12,26,8,2,162,98,51,43,3,41,15,10,24,15,17,6,3,2,1,51,459,67,54,13,117,22,6,9,12,3,9,18,5,9,20,609,3,82,57,1,0,9,8,3,2,2,10,45,11,36,14,46,1,0,4,100,7,14,18,13,34,6,11,43,2522,6,2,37,605,3,2,13,5,45,40,12,37,4,27,8,40,84,10,38,10,127,41,33,65,6,5,0,8,1,22,149,0,276,146,36,7,7,21,5,36,60,3,54,35,181,46,18,0,1,6,0,4,1,7,0,79,3,5,36,1,11,36,10,5,11,13,7,31,19,133,19,3,5,2,189,3,9,1,71,8,16,43,187,39,65,9,1,60,41,13,213,72,57,1,6,2,12,15,3,10,9,20,4,1,3,0,8,1,1,4,28,3,11,2,5,126,182,1,0,70,28,25,20,0,16,23,13,2,0,2,71,53,29,1,14,28,6,0,3,53,137,17,6,51,5,4,76,0,1,3,116,10,126,2,1,168,0,3,8,10,6,49,1,3,9,65,16,22,5,35,4,4,1,0,121,10,6,6,125,1,1,54,25,5,60,17,13,3,28,29,10,4,165,2,2,2,0,2,4,173,10,18,0,2,1,16,2,5,1,17,4,2,19,2,1388,2,11,56,1,6,3,4,5,14,0,17,4,2,0,3,0,97,1,10,9,186,5,102,1,1,15,0,5,37,3,5,11,0,0,1,2,47,2,22,4,33,9,61,0,1,3,19,14,170,29,0,1,2,11,64,5,26,5,19,3,18,78,5,1,12,2,7,25,7,0,0,0,2,0,2,261,4,8,25,23,60,10,70,2,73,2,3,16,8,2,7,22,10,287,1,3,1,0,8,46,12,34,1,135,27,1,2,233,1,1,2,10,5,124,26,2,7,9,1,7,0,6,2,1,1,1,202,11,152,1,36,21,0,115,3,60,0,27,2,1,0,4,10,11,68,3522,9,14,68,81,3,165,0,8,21,1,19,3,2,2,3,22,40,18,0,3,3,0,5,0,21,8,0,12,1,25,5,6,4,15,3,5,0,13,3,58,3,25,2,4,12,14,67,0,0,8,17,1,54,1,5,1,10,3,0,41,42,0,1,0,1,15,45,2,0,1,1,33,2296,2,7,143,79,0,3,0,1,33,3,16,16,12,4,5,6,0,1,30,2,1,0,13,2,25,5,0,0,42,8,0,2,0,0,27,32,1,4,19,1,6,0,60,10,72,2,138,0,1,34,1,0,0,0,2,1,1,15,26,0,191,6,9,1,7,2,48,2,2,0,0,2,84,0,243,2,0,6,0,1,13,4,11,2,15,2,1,26,170,11,2,0,60,1,1,2,2,31,3,14,0,2,1,0,3,1,0,10,51,1,8,1,0,0,10,22,0,459,752,5,5639,0,1,14,2,3,5,1,540,15,0,2,5,13,4,0,0,0,5,158,0,0,4,7,18,1012,11,1,36,16,1280,0,3,7,33,2,0,2,130,2,12,1,2,26,4,0,1,1,28,39,8,11,0,7,7,1,4,0,148,3,2,0,0,10,230,9,1,1,66,1,0,54,91,3,1,0,19,4,9,26,10,1,28,7,1,1,2,0,1,20,3,11,4,0,15,1,20,7,1,16,19,188,0,14,0,42,3,0,39,2,1,12,1,15,63,4,4,13,0,0,0,3,47,0,12,8,0,4,0,1,1,1451,0,208,5,0,36,4,2,3,116,0,2,1,0,2,11,275,5,0,7,0,1,0,2,4,149,0,4,4,5,5,0,1,1,0,1,2,1,0,1,59,0,23,3,4,19,106,22,1,0,13,0,1,10,1,3,56,0,11,12,9,0,1,1,3,104,1,0,0,1,6,3,0,1,1,472,3,40,2,59,4,7,8,30,2,2,15,1,1,4,21,13,4,4,0,0,1,2,12,5,0,0,10,10,8,3,2,28,18,53,5,1,6,18,10,0,0,4,0,0,1,0,3,1,13,38,34,1,3,8,2,0,0,4,44,2,33,1,2,25,29,2,4,2,0,6,1,0,0,0,1,27,3,1,1,309,5,2,2,3,37,22,4,3,1,0,1,0,2,13,4,2,1,0,607,0,1,1,2,5,21,2,22,0,57,1,2,0,17,0,7,1,3,0,0,1,23,3,12,22,1,47,0,3,168,1,5,16,173,0,0,3,0,2,0,9,0,3,0,0,0,4,1,1,10,0,0,20,0,7,15,141,6,14,1,0,9,20,22,1,1,49,0,4,3,0,6,0,8,0,2,2,7,4,4,18,0,2,0,1,3,1,0,0,23,0,177,0,4,8,3,0,6,0,4,2,1,6,1,85,27,0,0,19,6,9,0,232,2,1,3,0,1,0,11,23,0,36,3,7,5,0,1,0,1,0,9,398,0,0,3,187,1,0,250,0,13,0,0,2,0,15,54,4,12,1,2,4,2,0,119,1,0,5,0,1,0,3,8,0,16,40,1,571,2,1,30,5,2,3,6,2,0,0,1,0,0,1,0,0,16,0,1,0,1,10,15,27,1,0,7,2,0,2,2,0,0,34,11,18,6,9,15,6,3,26,1,1,3,8,1,29,0,1,6,1,0,0,1,2,0,1,0,6,2,0,0,3,4,2,40,0,4,1,4,1,6,1,9,8,17,2,0,1,0,1,2,36,1,0,2,3,1,7,0,0,3,74,0,1,5,2,2,8,0,1,0,17,0,5,0,43,0,9,0,1,1,0,0,333,6,0,0,124,22,1,32,0,63,1,3,2,0,1,0,0,0,12,2,16,0,0,4,2,10,0,0,0,0,0,1,0,1,0,10,6,3,0,1,0,0,18,1,2,4,4,5,1,0,4,4,12,0,0,11,4,2,7,0,0,0,6,4,0,0,4,0,2,0,30,0,1,0,1,0,2,0,0,1,0,1,0,7,0,1,1,1,1,0,0,4,2,4,1,0,4,0,0,9,3,10,1,2,1,3,1,4,0,0,1,2,0,0,182,71,29,14,7,2,2,6,0,13,0,1,59,5,311,5,7,0,0,3,1,1,0,0,5,0,9,1,0,11,7,3,0,7,3,20,0,0,0,118,19,0,0,0,0,12,3,1,0,0,1,1,1,20,2,1,2,20,3,0,4,2,28,1,3,0,4,0,1,2,0,3,2,1,5,33,2,1,0,4,469,2,1,11,0,3,0,0,1,0,0,1,2,0,80,0,0,0,0,0,0,0,3,0,1,4,456,0,0,0,3,13,3,0,0,0,18,0,5,1,0,7,0,0,2,6,1,4,51,1,18,0,1,11,1,2,41,0,5,1,0,3,0,0,3,2,185,1,0,1,4,0,1,3,4,0,1,7,0,78,0,1,0,16,3,0,0,0,1,0,6,0,1,0,2,0,4,0,0,0,1,0,40,0,1,1,0,1,0,23,2,0,286,1,0,11,11,0,0,0,0,10,1,4,6,4,2,0,11,0,0,0,0,10,1,84,3,1,0,1,0,1,1,2,1,1,2,17,2,12,0,0,0,0,27,0,7,28,39,0,0,1,1,0,15,0,1,1,2,1,1,0,0,0,0,3,1,3,0,0,0,3,0,1,4,0,0,0,0,13,3,1,1,2,0,3,2,22,1,0,2,3,0,1,0,1,1,5,0,1,0,11,17,0,0,9,0,0,0,0,0,1,0,0,1,3,12,1,2,16,1,0,10,0,0,1,1,3,11,0,0,4,0,0,2,1,2,0,0,2,7,0,2,13,10,2,0,15,20,1,0,0,4,0,0,0,4,0,19,0,0,1,1,20,4,5,0,0,8,1,0,0,0,0,5,1,0,7,1,34,1,0,5,0,0,17,1,0,0,1,1,2,0,0,0,0,6,0,1,1,0,60,0,0,3,1,7,0,0,8,1,1,0,3,0,0,1,2,1,0,9,3,0,0,8,0,3,0,0,5,0,0,1,0,1,3,0,0,0,1,1,0,0,1,0,0,5,1,0,1,0,2,32,57,0,0,1,3,0,0,2,1,0,0,16,0,0,1,8,2,0,43,0,1,0,0,2,0,0,6,3,0,0,0,0,3,0,0,24,10,0,1,0,75,0,0,0,4,1,2,7,5,0,0,0,0,0,2,0,2,5,0,0,0,32,4,0,7,1,4,0,40,0,0,2,0,4,1,2,2,0,1,1,0,121,7,20,0,5,11,0,0,0,0,0,2,1,0,0,4,7,20,0,0,0,18,0,2,1,0,6,1,0,0,1,5,0,0,15,0,0,0,0,1,1,4,0,0,1,2,20,0,0,0,2,22,5,1,6,2,20,0,1,8,1,0,10,0,129,1,0,53,0,5,0,0,5,0,0,0,0,0,0,1,4,0,1,1,0,3,2,2,4,0,3,0,0,1,4,0,2,0,0,1,1,0,1,3,0,0,31,1,8,0,0,6,0,0,0,56,0,13,4,4,0,0,0,0,1,8,0,4,0,10,4,7,0,5,1,4,4,0,0,14,3,0,11,0,3,0,0,1,0,3,0,0,0,0,0,2,0,1,2,2,2,0,0,0,3,0,0,1,16,2,0,1,1,0,63,6,0,2,0,1,0,30,1,0,2,1,0,1,0,15,0,0,0,8,0,1,7,4,0,1,2,0,3,1,0,1,2,5,0,0,4,0,1,3,0,1,1,2,0,0,3,15,0,0,0,0,0,0,0,0,4,3,4,11,0,0,0,0,1,0,0,0,0,0,0,0,0,0,2,2,3,0,0,0,4,0,0,0,0,3,0,3,0,3,0,1,0,4,0,0,0,0,0,0,0,1,6,0,2,0,0,0,0,0,0,1,0,0,0,0,7,2,3,0,0,0,0,0,4,5,0,0,0,0,0,0,6,0,2,0,0,1,14,2,2,0,0,0,0,0,1,0,0,2,0,0,0,19,0,0,0,0,0,0,3,0,0,0,0,0,0,2,0,0,4,1,0,3,2,0,0,0,1,0,0,0,0,4,1,4,8,0,0,2,1,0,0,0,0,0,2,0,0,0,8,0,0,0,0,0,0,15,0,0,0,0,4,0,24,0,1,1,0,0,0,0,0,0,0,0,0,4,0,0,0,0,0,1,0,0,0,0,2,0,0,3,0,0,0,0,4,0,0,0,0,0,1,3,0,0,1,1,11,0,4,3,0,0,0,1,2,2,0,1,0,0,1,0,0,0,1,0,1,0,0,0,0,1,0,0,2,0,10,0,0,4,0,37,2,1,0,0,0,1,0,0,0,2,0,0,0,0,0,0,0,0,0,0,5,0,0,0,0,0,6,2,0,0,2,0,3,1,3,0,0,0,0,0,2,0,1,2,0,0,0,1,0,2,3,0,0,2,0,0,1,1,0,0,0,0,0,0,0,0,1,0,2,0,1,0,0,0,0,0,2,0,48,0,4,0,0,4,0,0,1,0,0,3,17,0,0,0,0,0,0,0,0,3,0,0,0,1,0,0,0,0,0,0,0,0,0,13,0,1,5,0,0,2,0,0,3,0,0,1,20,0,0,0,0,1,1,0,0,1,0,1,0,0,0,0,0,2,0,0,0,1,0,0,2,0,0,0,0,0,0,0,0,0,0,0,2,0,0,0,0,0,0,0,0,0,0,2,3,3,1,0,0,0,0,1,1,3,0,2,0,1,63,0,0,1,0,0,0,0,14,0,0,1,0,0,2,1,0,1,0,0,0,0,0,8,5,1,0,1,2,0,0,1,0,1,4,1,0,0,0,0,0,0,0,1,0,0,0,3,0,0,0,1,0,1,1,0,1,0,0,0,0,0,1,1,244,0,0,0,0,1,2,2,4,0,0,0,1,0,2,0,1,3,10,2,3,0,0,0,2,0,1,0,0,1,0,0,0,0,0,0,0,1,1,0,0,0,0,0,0,0,0,0,1,0,0,0,0,0,0,0,0,2,0,0,0,0,0,1,0,0,3,1,1,0,2,0,0,0,0,1,0,4,0,0,0,1,4,0,0,0,7,0,0,0,0,1,1,0,0,0,0,0,0,0,0,0,3,6,0,0,0,3,0,0,0,0,4,1,0,2,0,1,9,0,0,0,0,0,0,0,0,0,1,0,0,0,0,1,0,0,1,0,1,0,0,3,0,0,0,72,0,0,0,1,0,1,0,1,0,1,0,0,0,0,0,0,3,3,0,0,0,0,0,0,0,1,0,2,4,0,0,0,0,0,1,0,1,0,0,0,0,2,0,0,0,0,1,0,0,0,0,0,0,0,0,0,0,0,0,29,0,0,0,0,2,0,0,0,2,0,0,0,0,3,0,0,5,0,0,0,1,0,2,0,0,1,2,0,0,1,0,0,0,1,0,0,0,0,2,1,0,4,0,0,0,0,38,0,0,1,0,0,0,0,3,0,0,1,1,0,0,0,0,0,0,0,0,1,0,0,2,0,0,0,0,0,0,2,0,0,0,0,0,0,0,2,0,0,0,1,0,10,20,1,0,2,0,4,1,0,3,2,0,0,1,0,0,0,11,0,0,0,0,0,0,1,0,9,1,0,4,0,1,0,0,0,0,0,0,0,0,0,0,0,4,1,0,0,0,0,1,0,0,1,0,0,0,0,0,0,0,0,9,1,0,0,0,0,0,2,0,0,0,0,0,0,0,0,0,0,0,11,0,0,1,3,0,2,0,0,2,3,0,0,1,0,0,0,0,0,0,0,5,1,2,0,0,0,0,0,0,0,0,2,0,0,1,0,0,0,0,0,0,0,0,0,1,0,0,0,2,0,0,0,0,1,0,0,0,3,0,0,0,0,0,0,0,1,0,0,0,0,0,0,0,0,1,0,0,2,11,1,1,0,0,0,0,0,0,0,0,0,2,0,0,3,1,0,2,2,0,0,4,0,4,0,0,4,0,1,0,0,0,8,0,0,0,1,0,0,0,0,0,0,0,0,0,0,0,0,0,0,0,0,0,1,0,0,0,0,0,1,0,0,34,0,1,0,0,3,0,1,0,0,0,0,0,0,0,0,0,0,0,0,0,0,0,0,0,1,17,0,0,0,1,0,0,0,0,0,2,0,1,1,0,0,0,0,0,2,0,0,0,1,0,3,0,0,0,0,0,0,0,0,1,0,0,0,0,0,0,0,0,0,0,0,0,0,0,0,0,0,0,0,0,1,0,0,0,0,0,0,0,0,0,0,0,0,0,0,0,37,0,0,0,1,0,0,0,0,0,0,0,0,0,0,0,0,0,0,0,1,0,3,0,0,0,1,0,0,0,0,5,0,0,1,0,0,1,0,0,0,1,0,1,1,0,0,0,0,0,0,0,0,0,0,0,0,0,0,0,1,0,0,0,0,0,0,0,0,0,0,0,0,0,0,0,0,0,0,0,0,2,0,0,0,0,0,0,0,0,0,0,0,0,0,0,0,0,1,0,0,0,0,0,0,0,0,0,0,0,0,0,0,0,0,0,8,0,0,0,0,0,0,0,0,0,0,0,0,0,0,0,3,0,0,0,0,0,0,0,0,0,0,0,0,0,0,0,0,0,0,0,0,1,0,0,0,0,0,0,0,0,0,0,0,0,0,0,0,0,0,0,0,0,0,0,0,0,0,0,0,0,0,0,0,0,0,0,0,0,0,0,0,0,0,1,0,0,0,0,0,0,0,0,0,0,0,0,0,0,0,0,0,0,0,0,0,1,0,0,0,0,0,0,0,0,0,0,0,10,0,1,0,0,0,0,0,0,0,0,0,0,0,0,0,0,0,0,0,0,0,0,0,0,0,0,0,1,0,0,0,0,0,0,0,0,0,0,0,0,0,0,1,0,0,0,0,0,0,0,0,0,0
"Glioblastoma",2230,68,216,5320,23,611,107,461,76,109,60,74,10,147,58,22,954,27,57,82,419,28,1147,20,182,9,189,14,144,17,119,110,51,234,32,156,12,24,39,22,1531,721,1054,24,314,1475,10,160,415,16,449,10,37,90,78,38,20,17,273,167,1206,35,12,55,2648,23,312,71,190,14,14,535,2,44,50,25,110,219,14,106,276,456,294,26,96,2,167,5,88,18,96,375,31,30,41110,6,98,12,11,77,21,97,22,18,219,3,17,412,6,108,12,6,20,28,14,30,19,14,20,12,6,66,78,328,14,82,1923,25,12,17,21,247,230,24,91,173,2791,46,148,4,3,136,8,10,125,55,8,37,50,9,812,12,316,24,49,40,170,283,26,124,9,8,1,4,1,269,1185,8,14,7,251,2,7,9,7,142,51,14,49,17,13,104,311,10,17,169,3,6,4,26,14,244,20,4,1,217,16,9,7,17,4,2,1,5,2,9,65,260,7,322,1,11,259,34,5,110,10,3,10,121,1,35,1,5,5,90,18,1179,30,9,6,260,37,2,2,5,13,75,0,4,10,1,27,350,1,20,9,50,58,7,90,2,4,0,96,51675,3,47,28,181,41,4,15,17,33,13,169,54,380,18,35,34097,10,36,38,2,3,3,1,129,732,18,24,8,14,2,99,1,2,1,2,0,55,4,0,2,6,8,6,5,2,9,16,133,7,136,28,6,66,35,2,6,204,3,287,73,1,1,62,2,16,8,4,5,17,71,0,0,2,10,2,7,182,1,9,31,2,7,0,79,28,16,81,0,20,1,3,11,248,20,19,62,29,71,0,1,0,6,4,9,64,45,59,0,6,13,1,80,11,2,1,107,2,2,991,4,1,2,17,1,12,25,4,3,16,29,37,0,2,6,5,25,3,45,1,18,0,5,7,4,0,8,3,5,67,0,18,3,99,1,49,50,889,42,6,43,0,2,3,5,11,12,1,2,3,15,1,1,5,1,14,20,5,14,12,7,6,1,0,15,5,0,0,6,0,3,2,2,1,0,11,3,35,51,4,0,8,2,1,10,6,0,4,3,24,191,193,20,7,2,4,8,1,3,287,24,3,1,6,2,2,13,0,35,15,2,8,1,1474,1,110,20,3,6,5,6,16,2,5,1,47,1,30,65,0,0,4,4,51,6,34,6,27,2,9,9,4,18,0,4,0,19,3,3,1,295,1,6,1,0,2,9,81,43,4,5,9,6,2,274,19,11,49,6,64,30,29,13,10,5,0,3,1,0,25,0,2,13,17,268,12,82,1,1,0,34,46,0,1,14,0,9,7,6,0,4,1,0,12,1,50,0,2,5,6,0,2,0,73,4,6,1,1,4,6,0,13,2,0,3,3,1,85,0,6,3,5,1,2,1,10,0,1,2,0,156,2,4,7,2,2,0,1,26,4,22,1,1,0,8,41,1,25,1,0,58,20,5,2,4,8,2,0,20,79,0,131,0,0,0,1,4,8,0,1,0,0,0,0,0,0,1,1,0,28,0,0,0,23,6,13,1,19,19,72,3,0,0,25,2,5,63,16,10,49,2,5,127,14,0,32,130,3,0,8,1,18,0,4,2,1,1,8,12,0,0,3,1,0,1,2,2,6,0,2,40,17,1,15,2,2,5,2,0,11,3,3,1,2,37,0,1,19,5,1,3,21,4,0,26,7,46,10,13,3,0,9,0,2,5,28,0,11,0,0,18,8,0,0,5,64,20,30,1,26,1,4,0,0,7,11,6,1,1,2,0,0,0,7,0,17,120,0,1,3,1,0,4,1,39,1,1,90,14,8,1,1,0,15,1,2,42,0,9,0,2,1,2,15,3,2,0,2,0,0,17,6,25,3,12,1,1,3,7,16,1,0,9,4,7,1,2,0,2,13,84,0,0,1,12,8,0,0,73,0,4,1,0,0,0,2,1,1,0,0,1,2,36,31,4,0,41,6,5,7,1,0,1,0,9,2,88,0,3,0,10,151,2,8,0,3,14,21,5,0,0,2,0,0,17,28,69,5,0,0,0,12,24,4,5,2,0,4,2,14,28,1,27,7,0,12,0,1,0,1,166,0,0,15,28,0,9,88,4,3,2,8,1,28,80,94,9,5,3,4,0,5,0,17,0,1,22,2,27,1,5,7,0,76,3,13,0,2,0,10,1,8,0,1,35,0,1,19,40,32,0,9,1,10,1,16,0,1,8,6,0,95,104,3,1,2,1,0,6,1,8,13,1,2,2,0,1,0,1,1,5,1,10,2,2,0,4,11,2,11,4,9,0,1,0,5,20,21,1,1,56,3,1,1,1,0,0,0,1,0,1,5,1,0,1,1,7,3,0,1,2,0,14,0,3,0,0,0,3,3,1048,0,0,3,0,3,1,0,1,2,0,7,1,31,2,11,1,13,2,0,0,1,1,26,0,3,11,12,5,0,0,1,0,41,11,0,1,0,25,0,1,1,0,0,0,0,40,7,0,3,71,1,1,2,41,1,12,5,0,1,1,2,1,0,1,2,2,1,1,1,0,0,0,2,20,0,26,17,5,0,0,1,1,1,0,2,25,2,9,1,5,1,0,1,0,0,20,43,6,1,2,0,10,14,0,1,23,2,1,1,0,0,6,1,0,0,0,0,1,16,0,2,7,7,0,1,3,3,2,1,0,0,3,2,0,0,0,24,9,1,13,7,1,1,0,0,5,11,0,0,0,0,3,7,32,2,13,3,1,3,3,3,3,1,0,3,38,1,0,0,0,0,5,0,1,6,4,9,6,1,4,19,1,0,6,1,1,12,0,4,0,4,5,0,0,1,1,0,5,8,3,7,0,0,1,1,1,2,1,71,0,0,24,17,2,1,3,0,1,2,3,0,16,1,3,6,0,0,1,1,0,1,0,1,1,0,1,12,1,0,0,0,41,22,8,14,3,0,1,24,0,0,0,8,3,2,21,0,3,2,38,0,0,1,10,4,1,4,3,4,2,1,0,4,0,1,3,1,5,0,3,0,7,1,814,0,2,0,1,0,1,1,0,12,1,13,3,0,32,0,1,0,1,1,2,0,1,1,0,1,0,3,1,0,1,0,0,44,0,0,1,0,3,23,0,2,35,1,1,4,1,0,2,0,3,0,1,2,11,7,0,1,4,10,0,0,0,67,0,7,4,1,0,9,1,0,0,4,0,0,0,0,2,0,2,1,3,1,0,1,0,2,0,10,1,4,81,0,1,8,4,9,1,0,0,0,1,0,4,2,0,3,0,1,0,1,2,2,1,0,1,0,0,4,5,2,0,0,22,11,1,0,1,7,0,1,0,1,0,3,4,5,39,2,50,4,0,2,20,0,0,3,0,0,6,1,0,171,1,1,0,15,0,6,0,4,2,15,0,0,1,0,1,0,1,0,4,0,0,2,1,4,0,2,0,2,0,0,0,1,15,1,0,0,0,1,0,1,24,0,0,2,3,3,0,6,0,0,0,0,1,2,0,0,1,2,1,0,0,0,1,0,0,2,0,4,0,11,0,1,7,0,1,0,2,0,0,0,0,0,0,1,0,1,0,57,2,46,0,2,2,0,2,0,0,0,0,4,1,6,0,0,7,0,2,1,0,0,0,1,1,0,16,0,0,0,0,2,0,0,1,0,1,1,9,1654,12,4,17,0,1,0,0,1,0,4,0,4,17,0,1,0,0,0,0,0,18,0,1,1,1,1,0,0,0,0,1,1,0,4,0,1,1,4,10,0,3,0,0,1,46,1,1,1,2,0,0,0,0,12,0,2,2,0,1,18,0,1,2,2,0,118,6,11,1,5,0,2,2,5,1,27,3,1,1,6,0,13,0,0,1,0,0,21,0,2,0,1,1,1,0,1,0,1,0,0,0,8,0,0,1,0,4,26,10,1,0,0,0,7,32,3,0,0,0,2,1,2,1,0,0,1,1,3,0,0,0,0,0,0,10,0,4,5,10,1,34,0,64,0,2,1,0,9,0,1,6,0,2,8,0,1,1,3,0,8,0,2,2,1,0,0,0,0,8,4,0,1,0,0,1,0,2,12,4,0,6,1,0,3,0,0,0,2,13,6,0,1,0,3,0,1,3,0,1,10,0,2,1,4,0,4,0,0,2,2,0,15,0,0,0,7,0,0,1,0,0,0,0,1,3,3,2,1,0,2,0,0,0,0,38,0,2,4,1,0,0,1,1,1,1,18,1,1,2,5,10,0,3,9,5,2,2,1,0,0,2,4,17,7,3,1,2,0,23,0,0,3,0,11,0,1,0,1,2,1,0,0,0,4,0,0,0,0,0,1,0,1,2,0,0,0,11,3,31,0,7,9,9,0,8,22,0,8,0,3,1,6,2,0,0,1,0,0,0,1,2,0,0,0,0,1,9,0,1,1,0,7,0,0,0,1,0,0,0,9,1,0,0,0,0,0,1,0,0,1,3,1,2,0,3,7,15,1,0,0,0,0,0,24,0,0,0,1,0,0,0,0,10,3,1,0,3,2,0,0,6,1,0,0,6,2,1,0,0,0,0,0,1,0,0,2,0,0,0,0,3,16,0,0,0,0,0,0,0,0,30,2,0,0,0,0,0,1,0,0,0,2,0,2,0,0,5,3,0,14,0,1,1,0,0,0,0,0,0,0,0,0,114,0,0,0,8,0,0,3,0,14,4,1,0,1,12,0,0,4,1,0,1,1,0,0,0,0,3,0,0,1,0,2,6,2,0,0,0,2,0,0,0,1,48,12,0,0,0,0,0,5,0,0,0,2,1,0,0,0,0,0,4,0,3,1,0,0,4,1,2,0,0,0,0,0,0,0,0,0,3,0,0,1,2,0,0,0,9,0,0,0,0,0,8,1,0,1,0,1,0,0,0,0,3,7,1,0,7,0,2,0,0,1,0,0,7,3,0,0,0,0,0,1,0,0,0,0,0,5,0,0,0,0,1,1,2,1,7,0,2,2,0,0,1,0,0,6,0,0,1,1,1,0,1,2,0,0,0,0,0,73,10,0,0,0,0,0,4,0,0,0,0,0,0,0,0,0,0,2,1,0,0,0,0,0,0,3,0,1,1,0,0,3,0,0,1,4,0,0,0,0,1,0,0,0,0,1,2,0,0,1,3,0,1,0,1,0,0,0,0,0,0,1,2,1,0,2,0,0,0,0,0,0,0,0,0,0,0,1,0,4,0,0,0,1,1,0,0,0,0,0,0,0,15,0,0,0,0,0,0,0,2,0,0,6,5,0,6,0,1,0,2,0,1,1,0,0,4,2,0,0,0,1,0,19,0,0,0,0,0,0,3,3,1,0,0,3,0,1,0,0,1,1,0,1,1,0,0,0,1,0,0,1,0,0,0,4,2,0,1,0,0,5,0,0,0,0,0,1,0,0,8,0,0,0,0,1,0,0,0,0,1,0,2,0,0,1,2,0,0,2,2,1,0,0,3,2,0,0,0,1,4,0,0,1,11,1,0,0,0,0,0,0,1,0,0,4,0,0,0,19,9,0,0,4,0,12,0,1,0,0,1,0,4,0,0,3,0,2,7,0,3,0,0,0,8,0,1,1,0,2,1,0,0,0,1,4,0,1,42,1,0,1,1,1,1,96,0,4,1,2,2,0,0,0,0,0,3,0,0,0,0,0,0,2,0,0,11,0,0,2,0,0,0,0,0,0,0,12,0,1,0,0,2,2,0,0,1,0,0,0,2,1,0,0,0,2,0,0,1,0,0,1,2,1,0,0,3,0,0,0,0,0,4,0,1,1,0,0,0,0,0,0,0,4,3,1,2,0,0,3,1,0,0,0,0,0,0,0,0,0,2,0,3,0,0,0,2,0,0,1,0,3,0,1,0,1,0,0,0,0,0,0,2,0,0,0,0,0,0,1,0,0,0,0,0,1,3,0,0,1,1,2,2,0,1,5,0,0,0,0,0,0,0,0,3,1,0,0,1,0,0,0,0,0,0,0,0,0,0,1,0,0,0,0,0,0,2,0,0,0,0,60,0,0,0,0,0,0,0,0,1,0,0,2,0,0,1,149,0,31,0,0,0,1,0,0,2,0,1,0,0,0,0,0,0,89,0,2,0,0,0,0,0,0,0,7,0,0,0,0,1,0,1,0,0,0,0,1,0,0,0,2,0,2,0,0,0,0,1,0,0,0,0,0,0,0,0,0,0,0,0,1,1,0,0,1,1,0,2,0,0,2,1,4,0,1,0,0,1,0,0,2,0,0,1,0,2,1,2,1,1,0,0,0,1,0,0,18,0,0,1,0,2,1,0,15,0,1,0,15,3,0,1,0,4,0,0,1,0,0,0,0,0,0,0,0,0,0,0,0,0,0,0,0,0,0,0,1,0,0,0,0,2,0,0,0,0,0,0,0,0,0,0,0,0,4,0,2,1,6,0,0,1,0,443,1,0,0,0,0,0,18,0,1,0,0,0,0,0,0,0,0,1,0,0,0,0,0,1,0,0,0,0,0,1,0,1,0,0,0,0,0,0,0,2,0,0,1,0,4,2,0,2,0,6,0,0,0,0,0,0,0,0,0,0,0,2,4,0,0,0,0,0,0,0,0,0,0,1,0,0,0,0,1,2,0,1,0,5,0,1,0,3,0,0,0,1,0,0,0,0,0,1,1,0,1,0,0,0,0,0,0,0,0,0,0,0,0,0,0,1,0,1,0,0,1,0,0,0,0,0,0,0,1,0,0,1,0,0,0,0,0,0,0,0,0,0,0,0,0,0,0,48,0,2,0,0,0,0,0,0,1,0,3,0,0,0,0,0,0,0,0,0,0,1,0,0,3,0,0,0,1,3,0,0,0,1,1,0,2,1,0,0,0,0,0,0,0,0,0,1,0,0,0,0,0,0,1,0,0,4,0,0,1,0,0,0,9,3,2,0,0,1,0,0,0,0,0,0,0,0,0,0,0,0,0,0,0,0,0,2,0,1,0,0,1,0,1,0,0,0,0,0,0,1,0,0,0,0,0,0,0,2,0,0,1,0,0,0,0,0,0,0,1,0,9,0,0,1,0,1,0,0,0,0,0,1,0,10,0,0,0,0,0,1,5,0,1,3,0,0,33,0,0,1,0,0,0,0,0,0,0,0,0,0,0,0,0,0,0,0,0,2,0,0,0,0,0,0,0,0,0,1,0,0,2,2,0,0,0,1,0,0,0,0,0,1,0,0,0,0,0,0,0,2,2,0,0,0,0,0,0,1,0,110,0,4,0,0,0,1,0,0,0,1,1,0,0,0,0,0,0,0,0,0,0,0,5,0,0,1,0,0,0,0,0,0,0,0,0,0,2,0,1,8,0,0,0,0,0,0,0,0,1,0,0,0,0,0,0,0,0,0,0,0,1,0,1,1,0,0,0,0,1,0,0,0,0,1,0,3,0,0,2,0,0,0,0,0,0,0,0,0,0,0,0,5,0,0,0,0,0,0,0,0,0,0,0,0,0,0,0,0,0,0,0,3,0,0,0,0,0,0,2,0,0,0,0,1,1,0,1,0,0,0,0,0,0,0,0,5,0,0,0,0,0,0,0,0,0,0,0,1,0,1,0,0,0,0,0,0,1,0,0,0,0,0,0,0,0,0,0,0,0,1,0,0,1,0,2,0,0,1,0,1,0,0,0,0,0,0,0,0,1,0,0,0,0,0,1,0,0,0,0,0,0,0,0,0,0,0,0,1,3,0,0,0,0,0,0,0,1,0,0,0,0,0,0,2,0,0,0,16,0,0,0,0,0,0,0,0,0,0,0,0,0,2,0,0,0,0,1,1,0,0,2,0,0,0,0,0,0,0,0,1,1,0,0,0,0,0,0,0,0,0,0,0,0,0,0,0,0,0,1,0,0,0,0,0,0,0,0,0,0,0,7,0,0,0,0,0,0,0,0,6,0,0,0,1,0,0,1,0,0,0,0,0,0,2,0,0,0,0,0,0,0,5,0,0,0,0,0,0,0,0,1,0,1,0,0,0,0,0,0,0,0,0,0,2,0,1,0,0,0,0,0,0,1,0,0,1,0,0,0,0,3,1,0,0,0,2,0,1,0,0,0,0,0,0,0,0,0,0,0,0,0,0,0,1,0,0,0,0,0,0,0,0,0,0,0,0,0,0,0,0,0,0,0,0,0,0,0,0,0,0,0,0,0,1,0,0,0,0,0,0,0,0,0,0,0,0,1,0,2,0,1,0,0,0,0,0,0,0,0,0,0,1,0,0,1,0,0,0,0,0,0,0,0,0,0,0,0,0,0,0,0,0,0,0,2,1,41,0,0,0,0,0,1,0,0,0,0,0,0,0,0,0,0,0,1,0,0,0,0,0,0,0,0,0,0,0,0,0,0,0,0,0,0,0,0,0,0,0,0,0,0,0,0,0,0,0,0,0,0,0,0,0,0,0,0,0,0,0,1,0,0,0,0,0,0,0,0,2,0,0,0,0,0,0,0,0,1,0,0,0,0,0,0,0,0,0,2,0,0,0,0,0,0,0,0,0,0,0,0,0,0,0,0,0,0,0,1,1,0,0,0,0,0,0,0,0,0,0,0,0,0,0,0,0,1,0,0,0,0,0,0,0,0,0,0,0,0,0,0,0,0,0,0,0,2,0,0,0,0,0,0,0,0,0,0,0,0,0,0,0,0,0,0,0,0,0,1,0,0,0,0,0,0,0,0,0,0,0,0,0,1,0,0,8,0,0,0,0,0,2,0,0,0,0,0,0,0,0,0,0,1,0,0,0,1,0,0,0,0,0,0,0,0,0,0,0,0,0,0,0,0,1,0,0,0,0,1,0,0,0,0,0,0,0,0,0,0,0,0,1,0,1,0,0,0,0,0,0,0,0,0,0,0,0,0,0,0,0,0,0,0,0,0,0,0,0,0,0,0,0,0,0,0,0,0,0,0,0,0,0,0,0,0,0,0,0,0,0,0,0,0,0,0,0,0,0,0,0,0,0,0,0,0,0,0,0,0,0,0,0,0,0,0,0,0,0,0,0,0,0,0,0,0,0,0,0,0,0,0,0,0,0,0,0
"Head and Neck Cancer",6370,1027,1344,43624,423,4276,1378,710,1152,2630,828,3297,282,648,959,430,12413,794,1133,545,984,349,40394,670,147,481,1109,2151,888,365,1007,1751,321,2283,750,1121,603,508,637,166,13800,12707,1612,251,850,2227,368,2112,763,2140,140,258,170,2513,546,571,244,1576,3513,6305,9857,809,275,285,25143,443,1206,1031,180,415,362,204,361,1376,1214,627,32,1446,141,1192,869,10468,21581,1549,5711,85,6753,344,21,373,3349,8405,4233,179,1400,97,921,106,57,3253,172,461,488,44,210,178,541,919,222,22991,148,109,417,289,907,1859,232,197,81,149,322,82,121,2954,265,509,12633,754,489,198,603,1551,4077,437,702,1020,297,200,457,1053,69,303,156,363,917,1416,73,227,50,71,5070,161,914,225,429,123,2041,2305,308,363,129,161,62,302,152,131,4101,461,128,157,1583,45,2300,367,147,108,252,336,504,103,44,4142,2143,28,111,964,70,58,378,126,1646,129,141,140,50,1516,693,427,621,2245,99,764,588,37,46,351,292,2277,52,2867,323,162,8791,652,84,936,529,56,135,106,242,113,41,269,57,129,220,1791,1145,100,653,1345,85,28,48,404,100,5884,173,33,131,607,1549,659,36,1728,34,274,1910,3691,664,92,76,37,520,606,51,513,56,360,816,496,2208,163,2624,26,1171,2032,760,90,546,459,58,109,35,6,86,453,17,45689,1756,58,193,94,593,37,681,34,15,103,37,38,1130,46,285,116,79,43,860,143,53,69,195,5310,25,5292,114,51,742,107,78,64,1387,6635,937,473,2530,26,20236,7,70,128,72,1018,128,443,74,265,14,40,397,303,319,256,158,51,34,944,145,296,508,399,114,76,4423,21,322,81,139,32,292,108,58,42,26,2268,231,293,542,29,47,23,217,20,539,441,149,129,47,10,23,6205,46,51,69,453,78,25,106,20,362,49,42,6370,206,21,182,93,23,27,57,206,8,33,13,296,187,731,38,336,1088,59,364,21,1891,44,61,65,1655,56,51,24,115,7964,114,50,314,83,57,46,102,1739,302,97,58,26,36,16,1128,160,9,331,37,28,106,144,47,27,9,52,132,170,16,92,6,189,39,17,9,13,105,98,444,357,44,12,9,22,52,34,239,21,247,20,58,397,762,24,105,72,239,95,33,57,3639,199,22,27,72,17,26,134,44,394,24,1,482,23,1271,14,2293,134,96,125,1452,35,46,228,56,76,46,21,463,20,23,15,231,112,3487,11,36,1585,179,34,289,1733,122,519,207,120,274,105,39,41,25,2713,23,84,4,53,69,87,6360,21212,54,1726,80,41,34,887,590,33,721,17,1556,68,105,160,245,103,9,23,21,53,656,453,91,132,381,3235,1969,75,162,38,11,150,97,65,28,111,470,68,2336,115,56,19,31,90,18,11,51,10,57,119,350,53,38,13,10,30,50,54,38,3545,122,213,70,52,99,1791,21,9,258,462,22,43,35,29,49,156,215,65,6,2621,182,344,60,851,41,25,2731,32,88,439,36,325,8,33,15,32,12035,28,5824,86,22,76,38,864,41,97,299,10,44,237,447,59,48,24,27,41,11,16,7,10,12,62,13,23,40,7,133,168,51,135,77,15,62,417,171,106,151,15,71,20,148,25,17,11,118,93,85,462,246,159,1088,471,46,1357,303,24,14880,1684,456,8,162,17,28,28,106,295,30,35,34,14,8,23,795,14,17,12,28,39,38,11,183,14829,321,3,6,41,20,214,9,2,73,1127,72,12,13,12,72,104,76,7,46,47,96,14,101,177,10,76,1407,156,14,18,267,30,17,12,162,13,844,104,6,1914,6,40,12,65,27,116,10,20,130,63,108,115,3,61,68,499,9,8,157,66,12,52,540,22,14,2012,279,232,21,295,13,17,60,232,17,10,998,150,172,114,28,10,23,113,20,49,6,67,18,60,6,29,3,199,17,29,111,36,201,12,27,155,38,18,98,5,1778,19,4,566,3,77,3,10,13,145,5,30,213,596,7,420,14,6,430,3,50,185,10,119,24,2,46,10,8,152,11,15,884,35,16,133,5,4,10,103,218,134,677,16,4,116,1446,165,28,852,8,26,247,151,167,163,12,4088,4,20,836,16,6,27,10,22,0,36,853,27,444,369,38,70,270,856,124,1006,8,134,32,14,14,22,38,378,562,32,13,17,8,11,151,113,9933,22,397,49,5,239,508,16,136,20,221,12,381,181,13,63,72,8,203,2,52,5,15,49,21,3006,87,1935,4,51,208,8,392,9,84,2,43,2,17,58,116,13,93,293,2839,14,78,328,180,47,479,1,32,1075,67,132,28,65,10,10,685,252,149,13,10,10,22,164,10,164,154,3,1082,11,1244,17,7,39,13,27,20,2,15,15,70,3,1131,14,123,25,179,21,15,1,37,50,6,52,12,285,16,28,9,11,62,100,1,40,4,3,97,707,5,14,1,23,44,1753,7,172,147,192,0,9,10,2,155,15,40,120,230,32,17,6,9,16,1133,21,19,2,49,10,1109,29,11,0,6965,599,5,11,2,103,175,37,4,31,521,6,6,2,385,18,354,129,296,899,9,143,18,5,28,1,3,5,43,396,164,7,196,697,119,26,60,47,44,7,11,27,7,6,115,2,60,23,3,39,7,139,191,21,40,12,40,12,126,104,335,24,7,104,866,4,0,6,14,237,7,1167,4,11,1,3,11,2,6,72,860,38,12,6,7,11,77,33,29,758,729,43,5108,34,4,50,4,11,15,592,391,14,2,2,305,341,23,70,1,1,187,1285,11,2,28,46,101,628,28,5,1458,95,1068,11,41,10,40,7,0,16,5420,4,9,1,32,249,40,4,109,7,46,116,50,35,138,18,11,7,23,22,95,37,29,2,2,298,894,54,573,13,84,20,4,139,614,11,0,83,149,91,47,51,214,6,2511,22,3,4,10,20,555,663,77,104,41,0,15,1,19,256,10,22,831,1187,13,76,440,93,3,124,275,3,3,120,12,91,33,73,12,24,6,13,5,8,46,5,21,54,8,14,8,2,4,1041,5,736,20,6,193,26,7,11,893,3,61,1,21,4,4,700,16,40,36,44,1,15,300,38,1409,195,38,34,1177,146,1,30,0,7,3,3,41,7,1,1497,5,6554,6,72,18,5118,51,8,14,34,0,16,164,201,19,651,30,61,10,8,6,16,15,6,59,2,8,16,15,37,52,3,25,3,375,155,122,21,47,8,11,61,55,4,30,235,2,2,17,43,132,5179,39,16,7,2,135,47,14,3,13,20,141,15,8,10,115,15,348,29,3,29,96,17,0,3,8,1,4,248,5,6,48,46,70,43,0,10,15,1,318,2,14,361,19,162,1,8,1211,636,7,48,2,5,16,13,4,10,5,9,5881,65,7,25,218,71,7,20,4,132,15,3,7,46,6,63,2,19,957,13,222,11,23,453,11,2,6,5,19,30,31,279,6,377,45,14,100,115,15,7,7,54,8,108,8,32,209,36,31,2,265,2,8,868,19,184,115,314,6,6,6,3,12,4,3,10,12,2,5,0,32,31,4,12,6,1,36,3,6,182,96,16,12,329,17,236,22,37,1,3,4698,0,109,12,88,12,5,15,1,26,10,13,14,13,2403,2,8,3,4,15,2,1,14,95,35,74,3,31,7,54,21,120,0,79,25,1,6,1,60,29,2,0,158,12,62,62,1058,28,14,54,20,20,51,9,25,4,506,37,19,35,2,2,3,37,62,7,309,3,331,173,175,7,2,158,37,13,15,2,20,8,1178,36,5,50,41,298,92,72,3,64,13,4,257,7,2,9,66,252,1,36,41,2,581,7,4,90,77,4,7,10,22,2,80,2,2,1,6,41,25,13,12,90,7,206,48,1330,403,2,0,583,23,3,7,707,3,2,51,9,504,9,530,457,12,110,555,3,781,15,5,26,507,155,2,7,13,1,2,9,38,2,9,12,15,6,28,0,10,11,6,118,3,1,5,86,8,8,10,10,18,166,10,5,5,2,6,14,136,1,3,5,26,7,574,13,1,2,88,1,8,11,18,4,15,4,3,11,113,4,146,10,551,2,230,31,47,10,4,1,349,186,1,4,221,940,15,122,3,335,5,5,11,0,4,26,10,13,73,11,574,5,0,45,5,7,5,8,109,7,0,3,1,19,0,897,14,1,0,6,75,2,1,0,5,12,55,11,11,65,84,154,25,48,10,29,124,11,99,5,4,18,56,26,0,0,16,7,1,10,171,0,2,1,47,18,80,0,3,8,2,9,24,5,5,6,4,0,6,47,13,81,85,9,1,17,80,1,20,4,2,737,4,11,4,33,15,15,5,18,54,5,6,2,349,2598,257,22,4,8,23,4,11,47,16,6,35,149,248,28,237,4,15,7,6,32,2,2,33,0,30,2,60,9,79,47,7,4,47,19,2,1,1,44,10,0,1,0,35,58,29,32,18,31,27,6,5,295,7,4,4,3138,72,82,18,8,161,12,27,189,90,10,42,45,4,142,8,8,14,131,31,21,5,22,392,316,1,7,5,23,3,0,68,2,0,34,0,0,138,1,3,1,117,0,9,2,64,14,14,27,386,3,4,0,10,701,8,1,211,0,196,0,9,2,3,16,0,1,342,16,16,96,125,3,183,5,2,29,141,81,5,5,13,2,0,16,14,2,6,17,123,1,6,46,4,2,2,51,83,0,3,21,4,109,4,5,13,254,47,7,1,239,3,1,1,11,0,2,31,5,25,1,43,2,17,1,597,1,2,43,12,1,1,21,30,12,235,4,47,141,300,0,1,3,0,5,14,8,478,9,7,0,12,3,4,3,4,677,6,290,16,17,2,1,18,8,14,0,0,11,90,91,10,25,3,0,19,5,2,1,14,142,113,0,0,2,31,1,111,3,2,5,6,3,7,24,0,1,0,57,3,17,0,1,6,5,4,5,36,1,5,0,5,14,617,6,2,40,6,27,2,41,4,19,1,10,2,4,2,1,10,15,8,4,16,361,1596,0,2,36,1,2,5,2,3,63,6,2,7,3,37,9,3,418,1,0,176,1,1,0,24,8,8,0,19,11,10,1,27,4,1,5,0,8,175,14,2,60,63,5,0,609,462,1,4,0,24,1,19,24,29,2,56,2,5,32,1,45,47,36,49,6,15,18,2,0,0,22,23,27,0,2,5,14,14,1,21,3,0,19,2,30,5,2,6,5,2,215,0,3,617,4,4,2,4,34,0,2,38,5,24,0,1,42,4,6,5,4,16,0,6,9,0,155,249,225,14,5,6,6,16,1,26,314,3,4,5,3,2,3,3,5,1,12,58,0,2,4,275,15,1054,52,4,4,3,7,35,35,12,4,38,1,2,8,4,39,1,0,17,0,11,2,36,13,19,74,16,1,0,2,5,2,0,296,4,2,1,115,1,0,3,20,147,14,2,3,2,952,1,4,0,59,4,3,319,18,1,1,0,5,0,33,8,58,1393,0,0,0,31,8,9,5,64,70,6,1473,2,9,6,39,130,14,9,4,1,8,9,0,131,12,20,0,45,2,3,0,2,5,1,7,5,40,0,10,98,35,5,5,0,88,9,6,39,10,23,14,0,17,18,31,17,0,65,271,1,29,1,2,31,44,0,0,9,4,210,2,3,2,120,275,30,1,93,42,249,0,3,95,3,0,87,0,115,2,1,72,20,9,0,6,5,0,0,1,0,5,0,33,119,28,2,33,239,3,9,3,9,72,14,0,13,5,6,1,22,0,0,5,6,6,1,14,137,0,72,6,41,1,43,16,1,4,3,126,8,102,1240,16,5,52,1,1,6,9,77,96,17,12,478,8,13,210,4,4,8,0,454,12,1,3,45,0,2,1,3,3,0,99,0,0,0,0,2,26,0,1,48,33,1699,2,0,2,2,1,11,18,22,31,0,2,174,8,196,159,87,991,11,1,1,46,20,0,7,93,0,34,7,11,0,0,1,40,7,265,2,115,0,21,24,227,1,9,5,3,5,555,0,1,2,4,0,8,1,1,2,13,2,11,354,65,0,4,0,1,25,1,0,0,113,35,73,317,0,8,27,1,31,5,12,5,4,0,8,10,4,76,3,3,3,0,1,1,605,13,2,2,0,4,2,3,2,5,32,154,3,76,0,20,2,13,33,21,0,12,56,0,2,0,2,0,2,93,6,8,3,76,8,2,43,6,3,18,0,1,2,2,11,33,0,147,1,0,6,23,148,0,12,0,0,12,93,14,3,0,2,1,3,0,47,24,0,47,0,5,2,15,2,0,5,0,0,151,6,2,163,29,72,1,1,777,2,1,8,50,0,24,3,36,50,3,8,3,0,0,0,106,2,14,1061,5,4,2,2,3,14,0,0,1,9,3,4,1,15,6,2,2,3,5,26,20,0,1,0,14,124,1,77,5,0,5,6,0,1,3,51,6,5,1,1,222,12,1,8,101,1,0,1,1,5,81,2,0,0,7,2,1,2,5,2,4,0,0,27,0,2,0,10,7,1,0,48,14,7,2,0,13,2,1,25,4,2,0,0,19,8,0,4,1,396,0,103,1,2,11,2,2,1,0,48,0,37,0,0,1,4,27,2,3,1,1,0,51,6,2,21,41,0,1,2,0,4,6,2,85,0,1,1,1,1,1,0,136,4,75,0,0,25,2,126,30,103,12,1,0,8,1,86,5,8,1,1,2,1,2,3,110,9,0,72,11,0,0,2,1,0,1,1,5,5,1,15,2,3,3,81,1,39,0,0,0,0,1,10,0,75,0,4,0,0,1,0,0,0,0,0,31,211,9,2,14,2,1,0,23,1,4,0,48,4,38,1,1,0,4,1,0,0,4,3,25,29,2,21,0,1,6,1,2,0,3,0,0,164,3,44,0,31,4,97,1,1,9,1,8,0,2,2,1,1,7,0,0,0,7,7,1,4,0,2,0,0,0,83,8,4,0,6,1,1,0,5,48,5,0,1,2,0,0,23,10,16,4,5,1,16,8,0,1,123,11,0,15,1,23,31,28,68,4,0,4,1,0,516,1,0,32,1,295,7,3,1,7,3,0,1,11,26,111,4,3,0,0,3,0,2,4,0,234,0,139,0,0,0,0,832,1,39,2,7,2,0,34,1,5,0,1,1,3,1,13,0,8,0,1,0,1,0,2,142,1,2,0,0,1,53,15,16,1,0,2,1,2,7,0,2,109,20,3,21,3,0,23,35,1,472,1,0,28,1,7,8,0,3,0,0,0,511,0,1,0,3,19,0,3,26,2,2,1,0,2,0,3,0,3,0,19,42,0,1,0,0,2,4,0,17,14,256,1,2,1,0,0,1,3,1,21,0,40,0,3,2,1,1,4,31,1,1,3,3,0,597,0,1,0,0,2,0,0,2,259,4,5,0,68,0,5,0,3,6,0,221,177,1,37,2,1,45,3,0,70,3,4,1,0,1,3,1,4,1,0,28,4,28,0,1,1,18,125,2,11,0,0,42,23,0,0,3,1,3,47,1,1,1,1,0,0,7,4,0,1,10,5,14,2,1,0,3,0,0,2,0,21,23,10,0,0,0,0,21,0,0,0,1,1,0,49,4,0,1,1,2,62,0,1,0,0,46,8,1,1,0,0,1,22,1,0,0,1,18,2,0,1,11,0,0,11,0,5,11,0,80,1,0,110,3,0,7,3,37,56,34,1,2,3,3,0,1,8,0,0,1,0,2,6,0,11,1,2,4,19,304,0,0,52,0,2,0,0,4,19,0,134,0,1,0,0,6,0,1,0,1,0,53,1,15,0,0,1,0,0,8,0,0,0,51,3,0,0,7,0,0,2,0,3,0,69,14,0,0,5,1,4,1,0,126,18,0,0,97,82,5,0,193,0,3,0,7,4,131,176,2,12,69,0,4,0,115,21,2,1,0,0,0,0,1,5,47,4,2,275,9,14,0,1,4,0,2,4,2,1,0,3,0,0,0,0,7,3,0,1,11,0,0,9,2,0,1,141,1,42,0,0,2,30,1,3,7,2,1,7,0,3,0,0,101,1,0,1,0,0,0,0,0,22,1,0,50,15,5,0,222,0,59,3,0,0,0,73,0,0,1,0,0,76,28,0,0,0,0,2,0,0,0,0,22,0,0,0,0,0,0,2,13,111,0,0,0,1,0,0,0,1,33,46,0,0,2,0,1,1,47,0,127,90,79,6,1,1,0,0,0,4,1,0,0,0,8,0,2,3,8,2,24,36,0,0,15,1,5,0,0,10,1,73,0,3,17,25,0,0,0,2,2,60,0,0,0,0,1,0,0,1,0,0,0,0,29,0,1,3,1,0,0,1,0,49,2,0,32,1,1,4,80,3,0,1,4,0,0,0,1,1,0,0,0,0,3,0,0,4,1,1,3,5,28,2,0,1,1,2,0,0,0,0,2,0,0,2,0,4,1,0,0,3,0,0,0,1,16,4,0,0,4,0,1,3,0,0,6,0,0,12,2,1,121,1,1,0,6,0,0,1,7,10,0,2,0,0,1,0,0,1,0,4,0,0,1,0,0,1,0,0,1,2,0,50,0,0,7,1,0,0,0,0,0,0,12,0,0,0,0,0,1,0,1,3,4,1,107,11,0,7,5,0,3,0,4,7,0,107,0,0,84,0,0,0,2,2,5,1,0,0,0,0,0,0,1,1,1,1,0,0,0,0,0,0,0,1,0,0,6,0,0,0,4,2,16,0,2,3,0,6,0,0,0,1,22,0,1,11,0,1,0,0,3,0,1,0,0,0,0,0,0,0,0,0,0,0,0,1,0,1,1,0,1,129,0,0,0,1,0,10,0,0,0,0,0,0,0,1,1,2,0,0,0,0,0,11,0,0,0,2,1,37,0,1,0,0,0,5,0,2,0,3,0,0,0,7,160,0,0,0,6,0,6,0,9,0,0,0,0,1,1,0,1,0,5,2,4,0,21,0,0,0,2,3,0,2,0,0,0,0,0,0,0,0,0,0,0,0,1,0,0,5,0,4,0,0,0,0,0,4,0,0,0,0,0,0,0,0,1,52,2,0,0,0,0,0,0,1,0,5,0,1,5,0,0,0,0,0,2,0,0,0,0,0,0,1,0,0,1,0,0,1,0,0,0,0,1,0,0,0,24,0,20,2,0,0,0,0,0,0,0,0,0,0,0,6,0,0,0,0,0,0,0,0,0,0
"Kidney Chromophobe",112,5,29,164,1,40,2,1,5,2,1,6,0,3,4,0,30,5,1,9,6,1,156,3,0,0,11,1,7,1,11,6,2,0,2,1,24,0,0,1,62,72,4,1,33,22,0,0,12,3,0,0,0,6,0,1,0,1,28,62,37,5,0,1,53,2,42,5,0,0,2,0,19,0,1,4,1,12,0,11,15,242,489,4,11,0,2,19,0,0,0,9,3,1,30,0,4,1,0,4,0,1,18,0,9,0,2,0,2,31,0,0,1,4,3,0,0,0,2,26,0,0,0,17,0,5,45,0,3,4,0,3,15,1,6,3,4,0,14,1,0,0,9,0,0,0,1,4,0,1,33,0,2,2,1,0,1,9,3,0,0,0,0,0,0,0,23,0,0,2,4,0,0,1,0,0,1,1,1,0,0,7,1,1,0,7,0,0,0,2,1,0,1,1,0,15,1,0,1,1,0,0,5,0,0,0,1,1867,0,39,0,0,22,2,3,1,0,1,0,0,0,1,0,0,0,0,0,14,0,0,0,37,1,0,0,0,0,89,0,1,2,0,23,0,0,2,0,0,0,1,1,0,0,0,2,19,0,1,0,1,12,0,5,1,3,0,1,0,35,1,0,2,0,0,0,0,0,0,1,24,9,1,0,0,0,0,49,0,1,0,0,0,7,0,3,2,0,0,0,0,0,0,2,2,0,3,0,0,2,2,0,0,8,2,0,0,0,0,1131,0,0,0,0,0,0,7,1,5,1,0,2,0,0,0,0,0,0,0,0,1,0,14,2,0,0,0,0,1,0,0,0,0,0,0,0,0,0,1,0,2,0,0,0,0,0,3,0,0,0,0,0,180,0,0,1,0,0,0,1,0,1,0,0,5,0,0,0,0,0,0,0,0,0,0,0,0,1,0,0,0,0,0,1,0,1,1,1,0,12,0,0,0,0,5,0,1,0,0,1,0,0,0,31,0,0,0,0,0,0,0,0,1,2,0,0,0,0,0,0,5,0,0,0,0,0,0,0,0,0,0,0,46,4,0,0,0,0,0,0,0,4,0,0,0,0,38,13,0,0,0,0,0,0,0,2,0,0,0,0,0,0,1,0,0,0,0,0,1,1,0,0,1,0,0,8,0,0,1,1,0,1,0,1,0,0,0,0,0,21,0,1,10,1,0,0,0,0,0,5,0,6,1,0,1,0,7,0,0,0,0,0,1,3,16,0,1,0,0,4,3,39,0,0,0,22,0,8,0,5,0,0,0,0,0,0,0,0,0,0,2,1,0,0,1,0,14,0,0,0,0,0,0,2,0,0,0,0,0,0,0,0,0,0,0,0,0,0,0,0,0,1,0,0,1,0,0,0,0,0,0,2,0,2,0,0,0,1,0,1,0,2,0,0,0,0,1,0,0,0,0,5,0,0,1,0,0,0,0,0,0,108,0,22,0,1,0,0,0,0,0,4,0,0,1,15,0,1,0,14,1,0,0,0,0,0,0,0,0,0,0,0,0,0,1,0,0,0,0,0,1,0,0,0,0,17,0,0,0,1,0,1,0,2,1,12,0,0,5,0,0,0,0,0,0,14,0,0,0,0,0,1,0,0,0,0,0,0,0,0,0,2,0,2,0,0,18,0,0,0,2,0,0,0,0,1,1,0,0,0,1,0,0,2,0,0,0,0,0,0,0,0,0,0,0,1,0,0,0,0,0,1,0,7,0,0,4,0,0,0,3,0,0,0,0,0,0,1,0,0,0,0,0,0,0,0,1,0,0,11,0,0,7,0,0,0,0,0,0,0,5,0,0,13,0,1,0,0,0,0,1,0,0,0,2,0,1,0,0,0,0,0,0,0,0,0,0,0,1,0,0,0,0,1,0,0,0,0,0,0,1,0,0,0,0,5,2,0,0,0,0,0,0,0,23,0,0,0,0,0,0,0,1,0,0,1,1,0,3,0,0,0,3,0,0,1,0,0,0,0,0,0,0,0,0,0,0,0,2,0,0,0,1,0,1,0,0,0,0,0,0,6,0,1,1,1,2,0,0,0,0,0,0,0,0,0,0,0,0,0,0,0,0,0,1,1,0,0,0,1,0,0,0,18,0,3,0,0,0,16,1,0,1,0,0,4,0,0,0,0,0,0,1,13,9,0,0,0,0,5,0,1,0,0,0,0,0,2,0,0,0,0,0,0,1,2,0,0,0,0,0,0,0,0,2,0,0,0,1,2,0,0,0,0,1,1,0,1,0,1,0,0,0,2,0,1,0,0,0,0,0,0,0,0,0,0,0,0,0,0,0,0,4,0,1,0,31,0,0,0,0,0,0,0,0,0,0,0,1,0,0,0,0,0,0,0,0,0,1,0,0,0,0,0,0,0,0,0,0,1,0,0,0,0,0,0,0,0,0,2,0,0,0,53,0,0,0,0,0,0,0,0,0,0,0,0,0,0,0,2,0,0,0,0,1,0,0,0,0,0,0,0,0,2,0,0,0,0,0,0,0,0,0,0,0,0,0,0,0,0,0,0,0,0,0,0,0,0,0,0,0,0,0,0,0,0,0,0,0,0,0,0,13,0,0,0,0,0,0,0,0,0,0,0,0,0,0,0,0,0,0,0,4,0,0,0,0,0,1,0,0,0,0,0,0,0,0,0,8,0,0,0,0,0,0,0,0,0,2,0,0,0,0,6,0,1,0,1,0,0,0,0,1,3,0,0,0,0,0,0,0,0,0,0,0,0,0,0,0,0,0,0,0,0,0,0,0,0,0,0,0,0,0,0,0,0,2,5,0,0,0,0,0,0,0,0,0,2,0,0,0,0,0,0,3,0,0,0,0,0,0,0,0,0,0,0,0,0,0,0,0,1,0,0,0,1,0,0,0,0,0,0,0,0,0,0,0,0,0,0,0,0,0,0,0,0,0,0,137,0,0,2,0,0,0,7,0,0,0,0,0,0,14,0,0,0,0,0,0,0,0,0,0,0,0,0,0,0,0,0,1,0,0,0,0,0,0,0,11,0,0,0,0,0,0,0,0,0,0,0,0,0,0,0,0,0,0,0,1,0,0,0,0,0,0,0,0,0,0,0,0,0,0,2,0,0,0,0,0,0,0,0,2,0,0,0,0,0,5,0,0,0,0,0,0,0,0,0,1,1,0,0,0,0,0,0,0,0,0,2,0,0,0,0,0,0,0,0,0,0,0,0,0,0,0,0,0,0,0,0,0,0,1,0,1,1,0,0,0,0,1,1,0,0,0,0,0,5,0,0,0,0,0,0,0,0,0,0,0,0,0,0,0,0,0,0,0,0,0,0,0,0,0,0,0,1,0,0,0,0,6,0,0,0,1,0,0,0,0,0,0,0,0,1,0,0,0,0,0,0,0,0,1,1,0,0,4,0,0,0,0,0,0,1,0,0,0,0,0,0,0,0,0,0,0,0,1,0,0,0,0,0,0,0,13,0,0,0,0,0,0,0,0,0,0,0,0,0,0,0,0,1,0,0,0,0,0,0,0,0,0,0,0,0,0,0,3,0,0,0,0,0,0,1,0,0,0,0,0,27,0,0,0,63,0,0,0,0,0,0,0,0,0,3,0,0,13,0,0,0,0,0,0,0,0,0,0,0,0,0,0,0,1,0,0,0,0,0,0,0,0,0,0,1,0,0,0,0,0,0,0,0,0,0,0,0,0,0,0,0,0,0,2,0,0,0,0,0,0,0,0,0,0,0,0,0,0,0,0,0,1,0,1,0,0,0,0,0,0,0,0,0,0,0,0,0,0,0,0,0,0,6,0,0,0,0,0,18,0,0,0,0,0,0,0,0,0,0,0,0,0,0,0,0,0,0,0,0,0,0,0,0,0,0,0,0,0,0,0,0,0,2,0,4,0,0,0,0,0,1,0,0,0,0,0,0,0,0,0,0,0,0,0,2,0,1,0,0,0,0,0,0,0,0,0,0,26,0,0,1,0,0,30,0,3,0,0,0,0,0,0,0,0,0,0,0,0,0,0,0,0,0,0,0,0,0,0,0,0,0,0,0,0,0,1,0,0,0,0,0,0,0,0,0,0,151,0,0,0,0,0,0,0,0,0,0,0,0,0,0,0,0,0,0,0,0,0,0,0,0,0,0,0,0,0,0,3,0,0,0,0,0,0,1,0,0,0,0,0,0,0,0,0,0,0,0,1,0,0,0,1,0,0,0,0,0,0,0,0,0,1,0,0,0,0,0,0,0,1,0,0,0,0,0,0,0,0,0,0,0,0,0,6,0,0,0,0,0,0,0,0,0,0,0,0,0,0,0,0,0,0,0,0,0,1,0,1,0,0,0,0,0,0,0,0,0,1,0,1,0,0,0,0,0,0,2,0,1,0,0,0,0,0,0,0,0,0,0,1,0,0,0,0,0,0,0,0,0,0,0,0,0,0,0,0,0,0,0,0,1,0,0,0,0,0,0,0,0,0,0,0,0,0,0,0,8,0,0,0,0,0,0,0,0,0,0,0,0,0,1,0,0,0,0,0,0,0,0,0,0,0,0,0,0,0,0,0,0,0,0,0,0,6,0,0,0,0,1,0,0,0,0,0,0,0,0,0,0,0,0,0,0,0,0,0,0,0,0,0,0,0,12,0,0,0,0,0,0,0,0,0,0,0,0,19,0,0,0,0,0,0,0,0,0,0,0,0,0,0,0,1,0,0,0,1,0,0,0,0,0,0,2,0,0,0,0,0,0,0,0,0,0,0,0,0,0,3,0,0,0,0,0,0,7,0,0,0,0,0,0,0,0,1,0,0,0,0,0,0,0,0,0,0,0,0,0,0,0,0,0,0,0,0,0,0,0,1,0,0,0,0,0,0,0,0,0,0,0,0,0,0,0,0,0,0,0,0,0,0,0,0,0,0,0,0,0,0,0,0,0,0,0,0,0,0,0,0,0,0,0,0,0,0,0,0,0,0,0,0,0,0,0,0,0,0,0,5,0,0,0,0,1,0,0,0,0,0,0,0,0,1,0,0,3,0,0,0,0,0,2,0,0,0,1,0,0,0,1,0,1,0,0,0,0,0,0,0,0,0,1,0,0,0,0,0,0,0,0,0,0,0,0,0,0,0,0,0,0,0,0,1,0,0,0,0,0,0,0,0,0,0,0,0,0,0,0,0,0,0,0,0,0,0,0,0,0,0,0,0,0,0,0,0,0,0,408,0,0,0,0,0,0,0,0,0,0,0,0,0,0,4,0,0,0,0,0,0,0,0,0,0,0,0,0,0,0,0,0,0,0,0,0,0,0,0,0,0,33,0,0,0,0,0,0,1,0,0,0,0,0,0,0,0,0,0,0,0,0,0,0,0,0,0,0,0,0,0,0,0,0,1,0,0,0,0,0,0,0,0,0,0,0,0,18,0,0,0,0,0,0,0,0,0,0,0,0,0,0,0,1,1,0,0,0,0,0,0,0,0,0,0,0,0,0,0,0,0,0,0,0,0,0,0,0,0,0,0,0,0,0,0,0,0,1,0,0,0,0,0,2,0,0,0,0,0,0,0,0,0,0,0,0,2,0,0,0,0,0,0,0,0,0,0,0,0,0,0,0,0,0,0,0,487,0,0,0,0,0,0,1,0,0,0,0,5,0,0,0,0,0,0,0,0,0,0,0,0,0,0,0,12,0,0,0,0,0,0,0,0,0,0,0,0,0,0,0,0,0,0,0,0,0,0,0,0,0,0,0,0,0,0,0,0,0,0,0,0,0,0,0,0,0,0,0,0,0,0,0,0,0,0,0,0,0,0,0,0,0,0,0,0,0,0,0,0,0,0,0,0,0,0,0,0,0,0,0,0,0,0,0,0,0,0,0,0,0,0,0,0,0,0,0,0,0,0,0,0,0,0,0,0,0,0,0,0,0,0,0,0,0,0,0,0,0,0,0,0,0,0,0,0,0,0,0,0,0,0,0,0,0,0,0,0,0,0,0,0,0,0,0,0,0,0,0,0,0,0,0,0,1,0,0,0,0,0,0,0,0,0,0,0,0,0,0,0,0,0,0,0,0,0,0,0,0,0,1,0,0,0,0,0,0,0,0,0,0,0,0,0,3,0,1,0,0,0,0,0,0,0,0,0,0,0,0,0,0,0,0,0,0,0,0,0,0,0,0,0,68,0,0,0,0,0,0,0,0,0,0,0,0,0,0,0,0,0,0,0,0,0,0,0,0,0,0,0,0,0,0,0,0,0,0,0,0,0,0,0,0,0,0,0,0,0,0,0,0,0,0,1,0,0,0,0,0,0,0,0,0,0,0,0,0,0,0,0,0,0,0,0,0,0,0,0,0,0,0,0,0,0,0,0,0,0,0,0,0,0,0,0,0,0,0,0,0,2,0,0,0,0,0,0,0,0,0,0,0,0,0,0,0,0,0,0,0,0,0,0,0,0,0,0,0,0,0,0,1,0,0,0,0,0,0,0,0,0,0,0,0,0,0,0,0,0,0,0,0,0,0,1,0,0,0,0,0,0,0,0,0,0,0,0,0,0,0,0,0,0,0,0,0,0,0,0,0,0,0,0,0,0,0,0,0,0,0,0,0,0,0,0,0,0,0,0,0,0,0,0,0,0,5,0,0,0,0,0,0,0,0,0,0,0,0,0,0,0,0,0,0,0,0,0,0,0,0,0,0,0,0,0,0,0,0,0,0,0,0,0,0,0,0,0,0,0,0,0,0,0,0,0,0,0,0,0,0,0,0,0,0,0,0,0,0,0,0,0,0,0,0,0,0,0,0,0,0,0,0,0,0,0,0,0,0,0,0,0,6,0,0,0,0,0,0,0,0,0,0,0,0,0,0,0,0,0,0,0,0,0,0,0,0,0,0,0,0,0,0,0,0,0,0,0,0,0,0,0,0,0,0,0,0,0,0,0,0,0,0,1,0,0,1,0,0,0,0,0,0,0,0,0,0,0,0,0,0,2,0,0,0,0,0,0,0,0,0,0,0,0,0,0,0,0,0,0,0,0,0,0,0,0,0,0,0,0,0,0,0,0,0,0,0,0,0,0,0,0,0,0,0,0,0,0,0,0,0,0,0,0,0,0,0,0,0,0,0,0,0,0,0,0,0,0,0,0,0,0,0,0,0,0,0,0,0,0,0,0,0,0,0,0,0,0,0,0,0,0,0,0,0,0,0,0,0,0,0,0,0,0,0,0,0,1,0,0,0,0,0,1,0,0,0,0,0,0,0,0,0,0,0,0,0,0,0,0,0,0,0,0,0,0,0,0,0,1,0,0,0,0,0,0,0,0,0,0,0,0,0,0,0,0,0,0,0,0,0,0,0,0,0,0,0,0,0,0,0,0,0,0,79,0,0,0,0,0,0,0,0,0,0,0,0,0,0,0,0,0,0,0,0,0,0,0,0,0,0,0,0,0,1,0,0,0,0,0,0,0,0,0,0,0,0,0,0,0,0,0,0,0,0,0,0,0,0,0,0,0,0,0,0,0,0,0,0,0,0,0,0,0,0,0,0,0,0,0,0,0,0,0,0,0,0,0,0,0,0,0,0,0,0,0,1,0,0,0,0,2,0,0,0,0,0,0,0,0,0,0,0,0,0,0,0,0,0,0,0,0,0,0,0,0,0,0,0,0,0,0,0,0,0,0,0,0,0,0,0,0,0,0,0,0,0,0,0,0,0,0,0,0,0,0,0,0,0,0,0,0,0,0,0,0,1,0,0,0,0,0,0,0,0,0,0,0,0,0,0,0,0,0,0,0,0,0,0,0,0,0,0,0,0,0,0,0,0,0,0,0,0,0,0,0,0,0,0,0,0,0,0,0,0,0,0,0,0,0,0,0,0,0,0,0,0,0,0,0,0,0,0,0,0,0,0,0,0,0,0,0,0,0,0,0,0,0,0,1,0,0,0,0,0,1,0,0,0,0,0,0,0,0,0,0,0,0,0,0,0,0,0,0,0,0,0,0,0,0,0,0,0,0,0,0,0,0,0,0,0,0,0,0,0,0,0,0,0,0,0,0,0,0,0,0,0,0,0,0,0,0,1,0,0,0,0,0,0,0,0,0,0,0,0,0,0,0,0,0,0,0,0,0,0,0,0,0,0,0,0,0,0,0,0,0,0,0,0,0,0,0,0,0,0,0,0,0,0,0,0,0,0,0,0,0,0,0,0,0,0,0,0,0,0,0,0,0,0,0,0,0,0,1,0,0,0,0,0,0,0,0,0,0,0,0,0,0,0,0,0,0,0,0,2,0,1,0,0,0,0,0,0,0,0,0,0,0,0,0,0,0,0,0,0,0,0,0,0,0,0,0,0,0,0,0,0,0,0,0,0,0,0,0,0,0,0,0,0,0,0,0,0,0,0,0,0,0,0,0,0,0,0,0,0,0,0,0,0,0,0,0,0,0,0,0,0,0,0,0,0,0,0,0,0,0,0,0,0,0,0,0,0,0,0,0,0,0,0,0,0,0,0,0,0,0,0,0,0,0,0,0,0,0,0,0,0,0,0,0,0,0,0,0,0,0,0,0,0,0,0,0,0,0,0,0,0,0,0,0,0,0,0,0,0,0,0,0,0,0,0,0,0,0,0,0,0,0,0,0,0,0,0,0,0,0,0,0,0,0,0,0,0,0,0,0,0,0,0,0,0,0,0,0,0,0,0,0,0,0,0,0,0,0,0,0,0,0,0,0,0,0,0,0,0,0,0,0,0,0,0,0,0,0,0,0,0,0,0,0,0,0,0,0,0,0,0,0,0,0,0,0,0,0,0,0,0,0,0,0,0,0,0,0,0,0,0,0,2,0,0,0,0,0,0,0,0,0,0,0,0,0,0,0,0,0,0,0,0,0,0,0,0,0,0,0,0,0,0,0,0,0,0,0,0,0,0,0,0,0,0,0,0,0,0,0,0,0,0,0,0,0,0,0,0,0,0,0,0,0,0,0,0,0,0,0,0,0,0,0,0,0,0,0,0,0,0,0,0,0,0,0,0,0,0,0,0,0,0,0,0,0,0,0,0,0,0,0,0,0,0,0,0,0,0,0,0,0,0,0
"Kidney Clear Cell Carcinoma",2148,402,1545,5744,132,1594,211,125,504,264,135,419,101,248,91,255,1265,289,170,304,317,113,6666,251,36,22,1006,114,948,58,712,906,79,27,63,100,1670,29,192,45,1812,1597,318,80,586,1451,14,12,327,83,26,20,38,461,183,76,81,49,706,1145,2787,186,54,51,2329,136,1491,163,27,19,115,64,939,39,222,131,10,924,28,658,264,7467,1954,273,438,6,325,805,9,134,63,1083,297,13,352,44,53,26,10,105,68,312,572,12,167,30,165,118,55,1233,107,20,31,102,59,32,96,98,45,1544,24,8,26,2362,37,526,1741,31,116,111,16,561,260,167,83,177,138,16,162,27,37,123,528,47,78,56,30,213,4,150,519,39,632,102,209,109,1079,1862,271,24,16,39,42,8,15,48,963,25,73,451,724,9,83,102,73,45,14,210,118,119,12,737,712,40,10,211,12,22,10,312,256,46,34,67,39,118,140,67,91,249,6,0,338,15,3,17,246,62973,13,1126,18,34,925,121,252,264,129,18,30,25,64,23,6,17,17,30,49,822,38,25,25,390,66,7,18,25,38,1439,22,85,27,0,887,38,7,135,11,27,105,56,60,13,15,7,82,264,101,107,35,64,133,6,240,150,85,34,376,111,397,175,94,119,31,10,3,3,11,3,10,578,215,60,15,85,10,9,595,18,21,10,14,1,246,14,289,32,15,2,22,8,6,42,48,420,5,430,29,5,162,10,21,4,226,61,86,49,28,17,4507,0,21,4,28,11,16,71,24,291,15,14,13,19,98,8,2,11,7,8,0,64,273,90,33,26,61,8,23,66,17,4,15,3,5,9,10,8,22,99,4,30,12,16,68,1,35,148,2,65,4,5,7,3866,39,9,35,18,23,11,55,8,65,49,46,117,4,4,21,58,11,49,11,67,4,11,7,40,24,6,28,12,30,42,6,1,211,6,21,8,112,19,2,4,46,594,4,12,0,20,121,5,31,81,151,79,5,6,6,7,6,46,4,95,71,6,7,5,3,28,1,48,80,0,5,86,46,12,3,21,11,2,14,1459,134,56,1,3,2,3,19,6,97,3,5,15,5,264,175,3,4,18,21,29,5,39,48,153,4,9,17,89,3,59,4,116,5,1,8,16,126,1,81,95,43,4,212,1,4,48,6,11,33,1,151,0,15,10,3,0,368,9,4,390,28,37,0,21,14,44,297,14,249,11,135,52,5,224,6,10,2,9,1,25,143,276,11,10,25,4,243,83,3498,61,22,1,479,31,69,24,35,4,1,4,2,0,143,37,23,7,16,47,45,24,2,85,15,137,9,2,8,14,6,2,306,51,1,12,47,1,6,1,6,1,16,23,41,3,9,0,2,9,25,6,11,78,6,0,34,13,6,35,7,2,78,6,5,3,40,7,33,2,34,12,5,16,0,240,11,15,1,15,58,18,50,69,1,12,2,5,1,16,600,2,733,14,10,5,7,7,18,28,111,6,12,18,252,37,12,5,286,10,0,4,6,6,0,30,7,5,1,1,2,20,6,4,16,11,2,4,97,46,11,4,7,6,151,0,156,2,26,24,81,22,23,75,296,9,6,99,28,9,116,33,11,0,1008,1,7,3,0,8,361,2,35,4,5,1,42,1,0,5,12,0,53,2,14,176,62,2,0,42,9,20,2,5,35,37,3,0,2,1,11,13,19,5,1,12,26,3,0,67,10,13,8,73,3,4,24,1,1,6,21,3,142,3,1,157,0,9,2,150,2,84,3,58,19,63,38,11,1,36,18,5,1,9,39,24,5,3,201,141,2,112,4,4,6,1,1,8,5,79,1,5,233,8,8,3,3,0,5,11,5,7,1,10,5,13,5,33,1,14,1,0,45,2,4,1,3,112,1,12,2,1,37,10,1,87,0,1,0,17,3,19,4,3,28,691,23,55,7,1,30,0,7,605,0,9,2,1,1,2,0,17,0,4,46,22,3,173,3,1,1,25,47,14,50,5,33,12,27,19,0,18,0,2,0,27,65,4,5,58,1,2,19,7,0,1,8,0,0,6,224,4,8,8,22,53,27,83,15,78,0,24,22,1,2,6,12,35,7,2,11,1,2,6,12,7,96,0,69,8,0,3,163,7,26,16,22,0,76,78,5,48,28,2,30,3,14,3,2,2,9,231,92,191,0,2,10,1,84,0,17,0,29,1,6,1,28,0,0,23,5,8,14,16,118,0,7,0,2,10,2,9,10,7,3,0,9,27,17,3,0,2,1,10,62,36,12,0,15,0,8,28,101,2,14,5,14,0,6,11,14,3,52,17,3,18,18,6,1,0,35,46,4,43,4,489,8,1,4,0,51,2,0,20,0,17,29,6,0,0,2,9,7,9,2,5,6,55,0,4,0,6,2,11,20,31,3,3,20,1,10,0,10,2,1,0,17,0,56,1,7,0,503,21,0,0,1,0,26,31,1,4,26,0,2,0,9,4,25,3,15,2,0,65,68,24,1,0,1,0,4,61,58,1,2,13,1,4,5,6,8,8,2,0,1,1,13,0,2,2,0,8,1,19,43,3,16,46,1,1,1,27,80,12,5,0,4,3,0,3,1,90,1,75,1,1,0,0,24,0,0,20,24,2,2,2,0,1,26,0,0,132,8,25,4,0,3,81,0,3,1,14,1,4,0,1,2,763,2,2,0,1,2,35,1,22,7,20,2,4,3,0,97,8,10,3,10,1,21,0,3,3,58,0,3,0,0,55,1,0,2,1,1,5,13,82,0,10,0,1,6,1,6,1,0,3,0,8,4,22,3,1,21,2,45,67,91,18,2,0,4,7,28,12,11,3,64,9,0,11,1,0,15,103,11,13,4,0,6,1,5,6,0,5,76,3,0,8,3,35,2,0,4,2,8,14,0,53,16,8,2,0,49,1,4,0,25,0,1,4,0,0,0,8,0,1,0,1470,16,1,141,0,3,2,111,1,38,1,2,1,16,86,1,2,2,6,5,31,1,13,9,1,4,5,12,11,0,0,0,0,8,0,8,5,0,16,0,91,4,26,6,6,1,11,14,19,0,1,49,2,4,7,10,7,1,14,0,6,4,1,11,0,0,1,1,6,19,1,0,2,11,1,96,5,1,20,2,4,11,0,0,170,0,0,5,8,2,29,2,1,0,0,6,33,4,1,3,53,28,1,1,7,7,5,14,28,5,20,99,8,0,2,6,0,1,1,0,7,0,20,11,1,2,0,1,0,2,1,4,14,6,16,0,11,45,27,2,7,5,48,43,1,2,1,0,4,103,0,4,0,1,21,0,6,0,8,17,21,1,5,0,0,0,2,4,4,3,3,0,1,1,0,1,0,171,5,3,4,2,178,2,0,0,35,0,0,0,5,0,5,1,8,4,15,13,0,16,30,3,12,8,3,23,13,0,113,15,0,14,3,0,4,6,0,2,0,5,1,1,1,0,1,11,0,2,38,3,3,4,0,2,20,1,63,0,0,4,1,16,23,2,1,0,4,0,0,1,1,5,3,18,1,1,1,0,4,0,1,1,32,1,1,5,6,4,13,5,3,0,2,1,0,14,0,5,2,0,0,1389,3,17,1,327,3,13,3,0,7,1,3,5,1,85,5,9,494,1,1,0,39,1,2,7,0,1,0,2,2,0,16,0,10,5,0,8,5,0,0,3,96,14,11,4,79,0,47,0,1,3,0,0,0,0,40,0,2,9,0,4,9,1,63,1,1,2,35,10,0,0,1,0,0,2,0,1,1,0,2,0,30,2,26,0,0,1,40,0,4,7,6,1,1,16,1,22,5,4,11,2,0,77,2,0,4,6,8,118,0,0,1,0,1,0,3,5,0,1,0,3,7,2,0,2,0,2,15,3,0,1,3,2,4,1,3,4,1,3,0,0,0,53,0,262,0,0,1,4,4,174,1,0,5,0,1,0,5,0,0,1,0,1,0,62,2,3,3,18,0,46,0,6,2,0,0,13,1394,0,1,79,13,11,225,0,111,0,3,1,4,1,1,15,2,4,0,9,0,0,0,3,0,1,0,1,0,1,0,1,0,6,95,1,0,0,10,2,0,28,0,0,4,1,0,1,0,1049,4,0,0,1,30,4,2,0,1,0,0,4,5,0,0,0,2,0,0,3,0,0,1,1,1,1,1,0,0,0,9,1,7,0,0,0,0,35,0,1,3,2,1,0,10,1,0,0,1,1,34,1,5,1,29,0,3,2,0,0,1,0,2,49,43,11,9,2,0,3,0,5,20,0,2,3,1,31,5,15,0,2,5,1,4,0,136,4,0,9,0,2,1,10,18,0,2,0,2,1,0,0,0,1,0,0,0,0,10,0,21,0,2,8,1,1,111,3,0,0,41,7,10,1,3,120,1,5,1,21,0,8,8,0,1,2,14,34,5,2,4,6,5,2,10,4,1,0,0,0,0,0,2,0,6,0,1,2,0,0,4,10,0,6,0,0,0,1,6,1,4,1,0,2,4,0,0,5,0,30,0,3,5,0,3,0,0,1,1,0,2,6,0,39,1,1,0,2,0,6,0,0,1,0,10,1,2,1,3,2,0,5,1,2,0,2,63,4,0,0,0,2,4,0,0,5,14,10,0,0,0,19,3,0,5,2,4,0,0,8,1,2,1,6,0,306,1,3,0,0,1,0,1,1,7,1,1,0,232,0,0,1,0,0,1,3,0,17,15,1,0,1,1,0,2,0,8,1,16,0,2,0,0,0,1,52,1,0,0,5,17,2,6,1,1,12,0,5,0,0,60,9,0,0,0,0,2,166,0,1,11,2,4,0,1,2,0,0,3,3,27,0,2,0,4,2,1,19,0,1,0,0,1,12,0,1,7,0,8,0,23,15,1,2,8,0,2,0,0,0,10,0,0,1,11,4,0,1,1,0,0,0,0,4,0,0,2,0,1,18,0,0,9,1,0,34,0,3,1,18,13,0,0,0,5,0,1,2,0,2,0,1,0,1,6,3,2,15,2,0,90,1,0,1,0,7,0,0,2,15,2,13,0,1,1,0,1,332,8,1,0,3,0,4,1,0,2,2,0,0,5,27,4,3,1,2,11,22,10,0,0,1,0,4,1,2,6,0,0,11,0,0,1,0,0,0,0,1,5,3,0,0,10,2,3,1,1,1,0,9,7,0,1,10,1,0,0,7,1,1,0,1,38,1,0,0,0,0,4,0,1,0,1,0,0,0,3,5,3,795,1,2,4,1,1,4,1,1,2,3,0,0,0,0,13,3,0,7,0,1,0,7,4,6,16,2,0,0,0,5,3,2,19,2,1,0,2,0,0,2,1,317,15,0,0,0,22,1,3,0,5,0,3,4,0,0,0,1,6,1,13,0,0,8,0,0,0,0,0,1,0,3,18,0,28,0,1,3,6,1,0,0,0,0,0,0,0,398,12,2,0,0,5,0,0,1,0,0,1,3,2,0,2,14,8,0,0,2,14,1,0,2,1,27,1,0,0,1,5,0,0,5,8,0,0,1,1,0,2,0,0,2,0,13,0,0,1,16,15,1,0,7,2,31,0,0,2,0,0,0,0,1,0,0,1,0,103,0,4,0,0,0,3,0,2,1,1,8,4,0,1,0,2,25,0,31,461,3,0,30,1,1,2,3,0,0,1,1,49,0,7,1,0,9,4,0,0,1,2,0,0,1,0,2,38,22,0,1,0,0,0,1,7,0,3,2,9,0,1,0,4,0,3,1,0,5,14,5,2,21,0,6,1,4,0,0,10,0,1,0,0,7,9,0,0,0,2,4,2,0,0,0,0,9,0,3,0,0,9,13,2,9,17,0,16,0,0,0,4,0,0,0,5,0,2,0,1,0,0,0,7,0,2,2,16,0,1,4,0,0,0,0,0,1,0,0,0,0,0,0,5,0,0,0,0,0,2,51,8,0,0,0,0,2,1,0,1,10,3,15,11,0,1,0,0,0,0,0,4,1,0,0,1,0,0,5,3,2,1,3,1,0,0,0,0,2,0,0,0,1,0,1,5,0,16,1,5,0,15,0,1,0,2,4,0,1,0,0,1,3,2,13,0,0,0,1,0,9,3,7,0,1,0,2,0,0,8,0,1,0,0,1,3,30,0,56,0,0,3,6,1,0,1,0,0,0,2,1,0,0,0,0,5,3,2,2,0,0,4,0,0,238,1,7,0,3,0,0,11,0,0,4,0,0,2,0,0,0,0,0,0,0,0,0,0,0,0,0,0,0,8,0,41,5,0,0,0,1,2,37,0,1,2,0,0,2,1,1,1,0,3,0,1,3,0,11,0,1,3,0,1,0,0,2,1,0,0,0,0,0,0,0,2,0,0,0,0,0,0,1,0,0,0,0,0,1,0,1,2,1,1,1,0,0,0,0,1,0,14,0,1,0,0,0,1,0,0,3,3,0,0,0,0,0,0,0,1,2,0,1,0,8,1,0,0,0,0,0,0,5,0,0,0,0,1,1,1,0,0,0,0,0,1,1,5,0,0,0,0,2,1,2,6,0,0,0,3,0,1,0,0,2,12,0,0,0,0,9,1,2,4,0,0,3,0,3,0,2,2,0,0,0,1,0,2,9,0,1,2,0,0,1,1,0,0,1,0,0,0,1,0,3,0,17,0,0,0,1,0,0,0,2,0,0,1,4,0,0,0,0,1,1,0,7,16,2,31,1,1,1,1,0,0,0,0,0,0,0,0,0,0,0,1,0,0,0,0,0,0,0,0,4,0,1,0,0,0,2,0,0,0,1,0,0,1,0,1,1,0,0,2,0,0,4,0,0,1,1,0,0,0,0,0,0,0,1,1,1,0,128,0,0,0,1,0,0,0,0,0,4,8,2,0,0,0,0,1,0,0,0,0,0,0,1,0,0,0,1,1,0,8,1,0,1,0,3,0,0,2,0,0,4,0,1,1,0,2,0,1,0,14,1,0,22,0,0,24,0,1,0,0,0,0,0,1,0,8,2,65,0,0,0,0,1,0,1,0,1,0,0,2,0,2,0,0,1,0,2,0,0,1,0,0,0,0,3,0,0,1,0,1,0,0,5,0,0,0,0,0,0,1,5,0,1,3,3,3,0,0,0,1,23,0,15,0,0,2,0,0,6,0,1,0,1,0,4,0,0,0,1,0,0,1,0,0,0,0,0,0,0,1,0,3,0,1,2,0,0,0,0,0,0,0,11,0,0,0,0,0,0,0,1,3,0,8,0,0,0,1,0,31,0,2,1,1,0,0,4,1,0,0,0,1,0,0,0,0,0,4,15,0,0,3,0,2,0,2,0,0,2,0,0,0,0,0,18,0,0,1,0,1,0,0,0,3,1,1,0,0,15,1,0,0,0,0,2,1,0,1,0,0,230,0,0,1,0,0,1,2,0,0,0,0,0,0,3,1,1,33,2,1,0,0,0,0,0,0,0,0,0,1,2,1,0,0,0,0,0,0,45,0,1,1,0,11,0,0,0,0,0,0,0,2,0,0,0,0,0,0,1,0,0,0,1,0,0,0,1,1,0,0,0,0,0,1,0,8,4,0,12,0,0,0,0,0,0,0,0,4,5,0,1,1,6,0,0,0,0,76,1,1,1,17,0,0,1,2,0,0,6,0,2,1,0,0,0,2,0,0,0,3,0,0,0,0,0,0,0,0,0,0,0,0,0,0,0,3,0,1,7,0,2,0,0,1,1,1,3,1,0,0,0,3,1,0,0,1,2,2,0,0,1,0,9,1,0,0,6,0,0,0,1,0,0,0,2,0,0,8,0,3,2,0,0,0,0,0,0,0,0,0,1,0,0,0,1,1,5,0,0,0,0,0,0,0,0,0,0,0,0,0,0,1,0,0,1,0,0,0,1,0,0,6,2,2,0,0,1,0,0,0,0,0,0,2,0,0,0,0,0,1,0,0,13,0,6,1,0,0,0,0,0,3,0,0,0,2,1,0,0,0,0,0,0,0,0,1,0,0,1,0,0,1,0,0,0,0,0,0,1,0,0,0,0,0,0,5,0,0,0,0,0,4,0,0,0,0,1,0,1,2,0,0,0,0,0,0,0,0,2,1,0,0,3,2,0,0,0,0,0,0,0,0,0,0,3,0,0,1,7,0,1,3,0,0,3,0,0,0,0,0,0,0,0,0,1,0,0,7,0,1,3,0,0,0,0,0,0,0,0,0,0,0,0,0,0,0,0,0,1,0,0,0,0,1,0,0,1,0,0,6,1,0,0,0,0,0,0,0,0,1,0,0,0,0,0,0,0,0,0,0,4,3,12,2,0,0,0,0,0,0,0,0,0,0,0,1,0,0,2,0,0,0,0,0,1,0,1,0,0,0,0,0,0,0,0,0,0,0,0,0,0,1,0,0,0,0,1,0,0,0,0,0,1,0,0,0,0,0,0,0,0,0,0,0,0,0,0,0,0,0,0,0,0,1,0,0,1,0,0,0,0,0,0,0,1,1,0,0,0,0,0,0,3,0,0,0,1,0,0,0,0,0,0,1,2,0,0,0,0,0,5,0,0,0,0,0,0,0,0,0,0,0,0,0,0,0,0,1,0,0,0,0,0,4,0,0,1,0,0,0,0,0,1,0,0,0,0,0,0,1,0,0,0,0,11,0,0,0,0,0,0,0,0,0,0,0,0,0,0,0,0,0,0,0,1,0,0,0,0,0,0,0,1,0,0,0,0,0,0,0,0,0,0,0,0,0,0,1,0,0,0,0,0,0,1,5,0,0,0,0,0,2,0,0,3,0,0,0,0,0,0,0,0,0,0,0,2,0,0,0,0,0,0,0,1,0,0,0,1,0,0,0,0,1,1,0,0,0,0,0,0,0,0,0,0,0,1,0,0,0,0,0,0,0,0,0,0,0,0,0,0,0,0,0,0,0,0,0,0,0,0,0,1,0,0,0,0,0,0,0,0,0,0,0,0,0,0,0,0,0,0,0,0,0,0,0,0,0,0,0,0,0,0,0,0,0,0,0,0,0,0,0,0,0,0,0,0,0,0,0,0,0,0,2,0,0,0,0,0,0,0,0,0,0,0,0,0,0,0,0,0,0,0,0,0,0
"Kidney Papillary Cell Carcinoma",255,11,56,383,3,104,4,3,14,7,3,31,4,8,13,5,91,7,9,14,10,1,408,6,0,0,28,5,20,0,21,39,3,0,6,8,115,1,4,1,161,115,12,3,73,67,0,0,26,3,1,1,1,20,5,3,3,1,101,164,71,15,0,3,149,9,73,13,0,2,2,5,96,0,4,10,0,26,0,23,24,508,533,16,61,0,14,103,0,5,2,24,8,3,44,2,4,3,0,6,0,4,38,1,16,2,7,5,3,107,5,0,1,10,2,2,0,3,6,54,1,0,0,43,1,15,84,0,3,3,0,5,22,3,9,5,8,1,22,2,0,1,53,5,1,1,0,14,0,10,64,0,9,2,1,4,5,22,8,0,2,3,1,0,0,1,66,1,3,17,9,0,2,6,0,0,1,2,4,0,0,38,6,5,0,15,1,0,0,13,4,0,4,3,1,3,5,4,2,7,0,0,26,0,0,0,1,3837,0,120,0,0,80,4,16,5,1,0,5,0,0,1,0,0,0,0,0,39,1,0,0,96,2,0,2,0,0,309,0,8,6,0,38,2,0,9,0,0,2,3,2,1,0,0,4,27,10,1,2,4,21,0,6,6,3,1,3,5,98,2,0,5,0,3,0,0,1,1,1,43,23,5,0,1,0,0,182,0,1,0,0,0,34,0,25,3,1,0,0,0,0,0,4,21,0,23,2,0,4,4,0,0,8,8,4,4,0,0,4077,0,1,0,0,1,1,8,2,25,1,0,1,1,2,0,0,0,0,0,0,1,7,9,0,1,4,0,1,0,0,0,0,0,0,0,0,1,0,7,1,2,0,0,2,0,1,10,0,1,0,0,1,366,3,0,4,1,0,0,0,0,5,0,3,8,0,0,1,3,0,0,1,2,0,0,0,0,0,0,0,0,0,0,1,0,3,1,2,1,19,1,0,0,0,27,0,1,0,1,10,0,0,0,10,3,0,0,0,0,0,1,0,2,4,0,0,0,0,0,0,9,2,0,0,1,3,0,0,0,0,0,0,168,14,3,0,1,0,0,4,0,7,0,0,2,0,69,23,0,0,1,2,1,0,0,2,1,0,1,1,10,0,2,0,0,0,0,0,1,5,0,8,3,1,0,18,0,0,1,1,0,4,0,1,0,0,0,0,0,32,0,2,91,0,1,0,0,0,3,26,0,20,2,8,0,0,10,0,0,0,0,0,0,28,22,0,0,0,0,37,4,341,1,0,0,36,0,44,1,1,0,0,0,0,0,2,2,2,0,0,2,2,0,0,4,2,92,0,0,1,1,0,0,8,4,0,0,4,0,0,0,0,0,1,1,0,1,0,0,0,0,1,0,0,6,0,0,0,1,0,0,1,0,4,0,1,0,0,1,1,0,2,2,0,1,0,2,0,1,0,1,7,0,0,5,0,1,0,0,0,0,570,0,54,0,2,0,0,1,0,0,10,0,0,0,27,0,0,0,46,1,0,0,0,0,0,1,0,0,0,0,0,0,0,1,1,0,0,0,1,1,0,0,1,0,25,0,9,0,1,0,2,1,0,6,35,0,0,6,1,0,1,0,1,0,93,0,0,0,0,1,20,0,0,0,0,0,2,0,0,0,0,0,1,0,1,131,0,0,0,3,0,0,0,0,1,1,0,0,0,1,1,1,1,0,0,0,2,0,0,1,0,0,0,3,0,0,2,0,0,0,1,0,14,0,0,8,0,0,0,6,0,0,0,4,0,1,0,0,0,0,1,0,0,0,2,2,0,0,55,22,0,3,0,1,0,0,0,0,0,9,0,0,38,0,0,0,0,0,0,0,0,0,0,2,0,2,0,0,0,0,0,0,2,0,0,0,0,17,0,2,0,0,2,0,0,1,0,0,0,0,0,2,0,0,1,12,1,0,0,0,1,0,0,105,0,0,0,0,0,0,0,1,0,0,2,0,0,13,0,0,1,2,1,0,9,0,3,0,0,0,0,0,0,0,0,2,2,0,1,3,0,0,0,0,0,0,0,0,0,1,13,0,0,0,1,4,0,8,0,4,0,0,0,0,0,0,2,1,0,0,1,0,0,1,0,0,18,0,2,0,0,0,31,0,0,0,2,0,22,5,0,2,6,0,5,0,0,0,0,0,0,3,19,8,0,0,1,0,13,0,1,0,1,0,0,0,0,0,0,2,0,0,0,3,5,0,1,0,0,1,0,0,0,2,0,0,0,4,2,0,0,0,0,0,0,0,2,0,1,0,2,0,5,1,1,0,1,0,0,0,0,0,0,1,0,0,1,0,0,0,0,9,1,1,0,63,0,0,1,0,2,0,0,0,0,0,0,1,0,0,0,0,1,0,0,0,0,3,0,0,0,2,0,1,1,0,0,0,0,0,0,0,0,0,1,0,1,0,3,0,1,0,111,0,0,0,0,0,2,1,0,0,1,0,0,0,1,0,3,0,1,0,0,2,6,0,0,0,0,0,0,0,7,0,0,0,0,0,1,0,1,0,0,0,0,0,0,0,0,0,0,0,0,0,0,0,0,2,0,0,0,0,0,1,0,0,1,0,0,0,0,31,0,0,0,0,0,0,0,0,0,0,3,0,0,0,0,0,1,0,0,32,0,1,0,0,0,3,0,0,0,2,0,0,0,0,0,65,0,0,0,0,0,4,0,1,0,0,2,0,0,0,5,1,0,0,2,0,0,0,0,0,6,0,0,0,0,3,0,0,0,0,0,0,3,0,0,0,0,0,0,0,0,0,0,0,0,0,0,0,0,0,0,0,4,9,9,2,0,0,0,0,0,1,0,0,10,0,0,1,0,0,1,27,0,1,1,0,0,0,0,0,0,0,1,0,0,0,0,4,1,0,1,1,2,0,0,8,0,1,1,0,4,0,1,0,0,0,0,0,0,0,0,1,0,0,0,279,2,0,5,0,0,1,3,0,3,0,0,0,1,22,0,0,0,0,0,4,0,0,0,0,0,0,1,0,0,0,0,0,0,0,0,1,0,4,0,72,0,2,0,2,0,0,1,0,0,0,1,0,0,0,0,0,0,1,0,0,0,0,0,0,0,0,0,0,6,0,0,0,0,0,5,0,0,0,0,0,0,0,0,17,0,0,0,0,0,3,0,0,0,0,0,1,0,0,0,12,0,0,0,0,0,0,1,0,1,0,8,0,0,0,0,0,0,0,0,1,0,1,2,0,0,0,0,0,0,0,0,1,0,1,0,0,1,1,1,1,0,7,3,0,0,0,0,0,33,0,0,0,0,1,0,0,0,1,0,1,0,0,0,0,0,0,1,0,0,0,0,0,0,0,0,0,8,0,1,1,0,14,1,0,0,3,0,0,0,0,0,0,0,0,0,0,0,0,2,0,0,0,0,0,2,0,0,17,1,0,2,0,0,0,0,0,0,0,1,0,0,0,0,0,3,0,0,5,0,0,0,0,0,1,0,22,0,0,1,0,2,3,0,0,0,0,0,0,0,0,1,0,4,1,0,0,0,0,0,0,0,1,0,0,0,0,0,2,1,0,0,3,0,0,0,0,0,0,0,0,86,0,0,0,90,0,1,0,0,0,0,0,0,0,7,0,0,43,0,0,0,0,0,0,0,0,0,0,0,0,0,0,1,1,0,0,0,0,1,0,0,0,0,1,0,2,0,2,0,0,0,0,0,0,0,1,0,0,0,0,0,0,0,2,0,0,0,3,0,1,1,0,0,0,0,0,0,0,0,0,0,3,0,0,0,0,0,2,0,1,0,0,0,0,1,0,1,0,0,1,0,0,5,0,1,0,0,0,26,0,0,0,0,0,0,0,0,0,0,0,0,0,0,0,0,0,0,1,0,0,0,0,0,0,0,0,0,0,1,0,0,0,5,0,8,0,0,0,0,0,10,0,0,0,0,0,0,0,0,0,0,0,1,0,5,0,0,0,1,0,0,0,0,0,0,0,2,136,0,0,10,1,1,29,0,13,0,1,0,0,0,1,1,0,0,0,0,0,0,0,0,0,0,0,0,0,0,0,0,0,1,3,0,0,0,1,0,0,0,0,0,1,0,0,0,0,187,0,0,0,0,1,0,0,0,0,0,0,0,1,0,0,0,0,0,0,0,0,0,0,0,0,0,0,0,0,0,2,0,0,0,0,0,0,0,0,0,0,0,0,0,0,0,0,0,0,0,3,0,0,0,5,0,0,0,0,0,0,0,0,2,1,0,0,0,0,0,0,0,4,0,0,0,0,0,0,1,0,0,0,0,0,0,23,0,0,0,0,0,0,0,1,0,0,0,0,0,0,0,0,0,0,0,0,0,0,0,4,0,0,2,0,0,1,0,0,0,9,1,2,0,0,2,0,0,0,2,0,0,0,0,0,0,0,4,0,0,0,1,2,0,1,0,0,0,0,0,0,0,0,0,0,0,0,0,0,0,0,1,0,1,0,0,0,0,1,0,0,0,0,0,0,0,0,1,0,13,0,1,0,0,0,0,0,0,0,0,0,0,0,3,0,0,0,0,0,0,0,0,0,0,1,0,0,0,0,1,0,0,0,0,0,0,3,0,0,0,0,0,0,0,0,0,2,1,0,0,0,4,2,0,0,0,0,0,0,0,0,0,0,0,0,32,0,1,0,0,0,0,0,0,0,0,0,0,46,0,0,0,0,0,0,1,0,0,0,0,0,0,0,0,1,0,1,0,3,0,0,0,0,0,0,4,1,0,0,0,0,0,1,0,0,0,0,0,0,0,8,0,0,0,0,0,0,11,0,0,0,0,0,0,0,0,0,0,1,2,0,0,0,0,0,0,0,3,0,0,0,0,0,2,0,0,0,0,0,0,4,0,0,0,4,0,0,0,0,0,0,0,0,0,2,0,0,0,0,0,0,0,0,0,0,0,0,0,0,2,0,0,0,0,0,0,0,0,0,3,0,0,0,0,0,0,0,0,0,0,0,0,0,0,0,0,2,2,0,0,28,0,0,0,0,1,0,0,0,2,0,2,0,0,0,0,0,11,0,0,0,0,0,1,0,0,0,1,0,0,0,7,0,1,0,0,0,4,2,0,0,0,0,2,0,0,0,0,0,1,0,0,0,0,0,0,0,0,1,0,0,0,0,0,2,0,0,0,0,0,0,0,0,0,0,0,0,1,0,0,0,0,2,0,0,0,0,0,0,0,0,0,0,0,0,0,0,0,0,291,0,0,0,0,0,1,0,0,0,0,0,0,0,0,13,0,0,0,0,0,0,0,0,0,0,0,0,0,0,0,0,0,0,0,0,0,0,0,0,0,0,53,0,0,0,0,0,0,1,0,0,0,0,0,0,0,0,0,0,0,1,0,0,1,0,0,0,0,0,0,0,0,1,0,1,0,0,0,0,0,0,0,0,0,0,0,0,115,0,1,0,1,1,0,0,0,0,0,0,1,0,0,2,5,0,0,0,0,0,0,0,0,0,3,1,0,0,0,0,0,0,0,0,0,0,0,0,0,0,0,0,0,0,0,0,0,0,4,4,1,0,1,0,6,0,0,0,0,0,0,0,0,0,0,0,0,7,0,0,0,0,0,0,0,0,0,0,0,0,0,0,0,0,0,0,0,244,1,0,2,0,0,0,0,0,0,0,0,13,0,0,0,0,0,0,0,0,0,0,0,0,0,0,0,31,4,0,0,0,0,0,0,0,0,0,0,0,0,1,0,0,0,0,0,0,1,0,0,0,1,0,0,0,0,0,0,0,0,0,0,0,1,0,0,0,0,0,2,0,0,0,0,0,0,0,0,0,0,0,1,1,0,2,0,4,0,0,0,1,0,0,0,0,0,0,0,0,0,0,0,1,0,0,0,1,0,0,0,0,0,0,0,0,0,0,0,0,0,0,0,0,0,0,0,0,0,0,27,0,0,0,0,0,0,0,0,1,4,0,1,0,0,0,0,0,0,0,0,0,0,0,0,0,0,0,0,0,0,0,1,1,0,0,0,0,0,0,0,0,0,0,0,0,0,0,0,1,1,2,0,0,0,0,0,0,0,0,0,0,0,1,0,0,0,0,0,0,1,0,0,0,0,0,0,0,0,0,0,0,0,0,0,0,4,0,1,0,0,0,1,0,0,0,0,0,0,0,0,0,0,0,0,0,0,0,0,0,0,0,0,0,255,0,1,0,0,0,0,0,0,0,0,0,0,0,0,0,0,0,0,0,0,0,0,0,0,0,0,0,0,0,0,2,1,0,0,0,0,0,0,0,0,0,0,0,0,0,0,0,0,0,0,0,0,0,0,0,0,0,0,0,0,0,0,0,0,0,0,0,0,0,0,0,0,0,0,0,0,0,0,0,0,0,0,0,0,0,0,0,0,0,0,0,0,0,0,0,0,2,0,0,0,0,0,0,0,0,0,0,0,0,0,0,0,0,0,0,0,0,0,0,1,0,0,0,0,0,0,0,1,0,0,0,0,0,0,0,0,0,0,0,0,0,0,0,0,0,0,0,0,0,0,1,0,0,0,0,0,0,0,0,0,1,0,0,0,0,2,0,0,1,0,0,0,0,0,0,0,0,0,0,0,0,0,0,0,0,0,0,0,0,0,0,0,0,0,0,0,0,0,0,0,0,7,0,0,0,0,0,0,0,0,0,0,0,0,0,0,0,0,0,0,0,0,1,0,2,0,0,0,0,0,0,0,0,0,0,0,0,0,0,0,0,0,0,0,0,0,0,0,0,0,0,0,0,0,0,0,0,0,0,0,0,0,0,0,0,0,0,0,0,0,0,0,0,0,0,0,0,0,0,0,0,0,0,0,0,0,0,15,0,0,0,0,0,0,0,0,0,1,2,0,0,1,0,0,0,0,0,0,0,0,0,0,0,0,0,0,0,0,1,0,0,0,0,0,0,0,0,0,0,1,0,0,0,0,0,0,0,0,1,0,0,4,0,0,5,0,0,0,0,0,0,0,0,0,0,0,10,0,0,0,0,0,0,0,0,0,0,0,0,0,0,0,0,0,0,0,0,0,0,0,0,0,0,0,0,0,0,0,0,0,0,0,0,0,0,0,0,0,0,0,0,0,0,0,0,0,0,0,0,0,0,5,0,0,0,0,0,0,0,0,0,0,0,1,0,0,0,0,0,0,0,0,0,0,0,0,0,0,0,0,1,0,0,0,0,0,0,0,0,0,0,4,0,0,0,0,0,0,0,0,0,0,2,0,0,0,0,0,3,0,1,0,0,0,0,0,0,0,0,0,0,0,0,0,0,0,1,0,0,0,0,0,0,0,0,0,0,0,0,0,0,0,0,0,0,0,0,0,0,0,0,0,0,0,0,0,0,1,0,0,0,0,0,1,1,0,0,0,0,57,0,0,0,0,0,0,0,0,0,0,0,0,0,0,0,0,0,0,0,0,0,0,0,0,0,0,0,0,0,1,0,0,0,0,0,0,0,9,0,0,0,0,0,0,0,0,0,0,0,0,0,0,0,0,0,0,0,0,0,0,0,0,0,0,0,0,0,0,0,0,0,0,0,0,0,0,0,1,0,0,0,0,0,0,0,0,0,0,0,0,1,0,0,0,0,0,6,0,0,0,0,0,0,0,1,0,0,0,0,0,1,0,0,0,0,0,0,0,0,0,0,0,0,0,0,0,0,0,0,0,0,0,0,0,0,0,0,3,0,0,0,0,0,0,0,1,0,0,0,0,0,0,0,0,0,0,0,0,0,0,0,5,0,0,0,2,0,0,0,0,0,0,0,0,0,0,0,0,0,0,0,0,0,0,0,0,0,0,0,0,0,0,0,0,0,1,0,0,0,0,0,0,0,0,0,0,0,0,0,0,0,0,0,0,0,0,0,0,0,0,1,0,0,0,0,0,0,0,0,0,0,0,0,0,0,0,0,0,0,0,0,2,0,0,1,0,0,0,0,0,0,0,0,0,1,0,0,0,0,0,0,0,0,0,0,0,0,0,0,0,0,0,0,0,0,0,0,0,0,0,0,0,0,0,0,0,0,0,0,0,0,0,0,0,0,0,0,0,0,0,0,0,0,0,0,0,0,0,0,0,0,0,0,0,0,0,0,0,0,0,0,0,0,0,0,0,0,2,0,0,1,0,0,0,0,0,0,0,0,0,0,0,0,0,0,0,0,0,0,0,0,0,0,0,0,0,0,0,0,0,0,0,0,0,0,0,0,0,0,0,0,0,0,0,0,0,0,0,1,0,0,0,0,0,0,0,0,0,0,0,0,0,0,0,0,0,0,0,0,2,0,3,0,0,0,0,0,0,0,0,0,0,0,0,0,0,0,0,0,0,0,0,0,0,0,1,0,0,0,0,0,0,0,0,0,0,0,0,0,0,0,0,0,0,0,0,0,0,0,0,0,0,0,0,0,0,0,0,0,0,0,0,0,0,0,0,0,0,0,0,0,0,0,0,0,0,0,0,0,0,0,0,0,0,0,0,0,0,0,0,0,0,0,0,0,0,0,0,0,0,0,0,0,0,0,0,0,0,0,0,0,0,0,0,0,0,0,0,0,0,0,0,0,0,0,0,0,0,0,0,0,0,0,0,0,0,0,0,0,0,0,0,0,0,0,0,0,0,0,0,0,0,0,0,0,0,1,0,0,0,0,0,0,0,0,0,0,0,0,0,0,0,0,0,0,0,0,0,0,0,0,0,0,0,0,0,0,0,0,0,0,0,0,0,0,0,0,0,0,0,0,0,0,0,0,0,0,0,0,0,0,0,0,0,0,0,0,0,0,0,0,0,0,0,0,0,0,0,0,0,0,0,0,0,0,0,0,0,0,0,0,0,0,1,0,0,0,0,0,0,0,0,0,0,0,0,0,0,0,0,0,0,0,0,0,0,0,0,0,0,0,0,0,0,0,0,0,0,0,0,0,0,0,0,0,0,0,0,0,0,0,0,0,0,0,0,0,0,0,0,0,0,0,0,0,0,0,0,0,0,0,0,0,0,0,0,0,0,0,0,0,0,0,0,0,0,0,0,0,0,0,0,0,0,0,0,0,0,0,0,0,0,0,0,0,0,0,0,0,0,0,0,0,0,0
"Large B-cell Lymphoma",831,90,125,2594,67,347,210,102,69,306,457,216,44,132,60,200,36998,55,224,549,229,54,1108,46,69,33,133,224,115,99,892,608,86,32,56,302,145,24,185,20,941,3175,242,19,301,104,13,21,171,278,18,11,16,419,39,392,309,46,286,127,409,80,135,11,1109,104,196,79,47,48,109,77,44,125,134,159,7,266,27,183,1116,233,212,62,481,4,30644,48,6,145,125,268,100,21,194,38,53,13,7,9,242,58,458,22,75,4,110,141,40,417,184,46,23,39,18,22,15,273,10,19,78,6,14,94,8,60,331,359,157,99,8,179,36998,37,2802,117,78,38,623,68,7,49,69,63,168,7,9,102,1,133,838,35,490,147,69,21,72,59,116,67,22,125,37,4,14,40,102,20,17,105,188,13,54,56,17,102,32,51,126,12,7,193,677,16,11,47,7,6,5,66,285,33,24,22,35,104,156,16,47,104,8,3,11,5,2,29,40,132,6,145,8,44,249,788,54,913,87,16,8,44,143,19,10,28,55,39,34,75,5,61,12,211,56,3,7,83,22,71,13,22,15,2,14,54,9,152,5,30,5504,21,78,22,31,5,109,106,19,64,19,91,16,12,45,156,85,16,350,5214,190,3,82,93,3,12,3,4,56,13,2,69,114,24,24,120,8,9,1055,19,1,6,10,0,45,16,6,39,16,1,8,8,5,28,13,153,4,154,16,7,14,10,114,2,370,50,13,61,38,4,77,5,23,0,41,29,9,5255,8,6,1,7,84,6,73,2,17,9,12,17,1,394,97,66,14,7,41,1,11,78,18,29,30,4,8,49,3,2,17,66,4,2,4,59,1200,1,10,290,3,29,6,3,3,1706,75,7,8,66,9,6,18,2,118,27,29,19,5,15,619,6,3,7,3,41,0,4,3,21,22,14,16,98,40,55,23,4,48,6,48,21,31642,18,15,43,65,72,11,21,3,2,45,6,16,28,53,19,11,8,8,2,26,65,1,9,15,7,22,12,1,5,1,24,96,1,3,15,5,107,5,13,7,0,12,64,38,43,3,2,2,5,5,4,41,8,0,2,3,108,87,3,4,14,19,11,8,5,81,38,6,23,2,10,3,35,36,194,3,4,4,16,100,1,95,6,8,9,898,1,5,34,2,21,1,1,41,3,32,12,88,5,35,7,38,54,32,13,5,36,23,333,4,16,4,16,38,37,2,175,9,3,6,5,0,25,33,45,26,13,6,11,17,76,40,38,158,1,30,39,82,33,3,42,0,2,7,7,286,9,9,5,146,78,8,22,5,30,3,135,6,6,15,31,1,1,104,63,1,19,11,0,15,3,8,3,13,19,8,0,23,1,3,31,331,31,3,129,51,5,79,9,8,13,1,2,277,1,29,1,45,7,26,5,1790,17,3,130,2,38,8,31,0,12,58,15,69,26,1,13,1,3,1,5,53,5,42,3,8,8,5,15,5,28,45,5,5,45,59,27,30,0,10,5,0,8,4,0,2,12,1,0,3,0,2,4,32,3,35,5,2,15,71,111,62,3,16,5,42,0,16,2,14,8,89,43,41,113,14,164,4,269,5,13,128,49,12,0,4,3,8,2,0,31,30,1,8,20,8,9,33,5,4,3,8,1,21,1,2,26,33,0,2,9,10,23,0,0,24,17,6,2,0,2,25,3,4,15,1,18,6,11,3,43,7,14,24,37,0,3,8,4,1,14,12,2,45,3,0,50,3,9,8,55,5,82,7,23,8,26,20,3,3,15,8,6,2,8,150,5,7,4,30,8,5,96,0,6,11,9,2,3,8,22,9,39,25,37,5,4,0,0,8,17,9,1,8,9,3,1,4,7,2,32,5,0,9,1,10,3,1,8,5,40,3,5,82,2,2,16,2,4,0,2,0,4,3,2,5,96,5,12,0,7,703,0,0,65,0,2,7,0,0,6,6,29,1,3,3,16,1,11,2,1,0,24,40,86,3615,4,9,3,34,6,1,9,0,5,1,26,107,8,3,11,1,1,1883,6,0,1,9,3,0,10,120,7,20,128,83,22,43,79,157,181,0,26,32,1,4,11,8,68,15,0,16,0,2,0,26,20,22,0,24,51,2,15,47,0,42,4,119,1,116,91,5,19,23,1,1,0,4,0,1,8,6,76,14,2,0,6,39,1,45,1,6,0,81,5,15,0,26,0,3,7,7,2,60,40,14,0,1,1,20,13,8,19,7,9,1,8,9,53,8,0,0,1,2,4,1,5,21,2,2,0,12,18,5,0,13,21,21,1,4,5,46,0,332,3,1,13,14,3,3,1,8,50,1,7,0,2,1,7,6,2,7,2,1,2,0,0,11,40,1,2,2,14,16,12,10,6,1,38,0,2,0,0,3,11,22,37,15,7,21,1,18,1,0,11,0,0,7,0,171,0,2,2,11,4,0,4,1,2,8,48,3,10,39,0,1,0,8,4,6,15,19,5,1,22,0,0,3,0,0,0,3,215,14,0,1,7,7,4,4,5,4,47,3,3,0,7,15,0,2,2,0,8,0,35,21,1,8,4,4,14,3,129,173,16,4,0,8,0,0,0,7,17,0,23,1,0,0,1,6,0,0,15,19,4,0,3,0,1,103,6,0,10,11,5,1,2,0,15,1,7,0,8,1,2,1,0,87,6,120,1,1,1,2,4,0,0,4,49,4,3,1,0,64,336,0,1,5,5,11,0,0,4,31,0,4,1,0,7,8,1,6,5,9,0,13,2,2,7,1,1,1,1,6,4,1,2,1,1193,9,4,2,2,16,0,9,125,51,74,0,1,11,14,214,1,395,26,4,49,0,8,0,0,6,17,20,17,22,0,8,0,3,8,2,10,110,10,0,17,4,39,0,2,49,0,1,3,1,27,21,308,4,2,8,0,2,0,4,2,4,8,1,10,4,0,0,5,0,23,33,7,34,0,0,5,5,0,0,0,1,0,6,35,1,7,1,11,0,0,8,11,31,1,4,3,56,1,1,0,0,1,1,1,55,6,0,17,2,10,2,35,54,13,0,10,7,116,0,0,12,4,3,1819,10,6,1,1,0,0,1,3,80,0,0,0,2,8,9,0,0,5,37,1,23,1,8,8,0,29,4,1,3,23,0,0,5,0,5,20,2,0,6,0,15,97,14,9,2,5,1403,0,0,4,4,2,7,116,0,4,23,1,0,0,6,2,0,1,0,7,11,6,13,7,2,5,4,1,8,0,21,12,10,18,0,3,42,8,2,12,1,3,7,0,4,0,2,2,20,0,2,0,1,13,1,1,1,3,40,5,16,549,1,7,0,11,10,11,9,4,0,2,1,2,0,3,3,1,253,77,0,191,11,0,0,76,0,6,0,7,2,1,0,2,15,6,1,0,4,0,4,5,4,3,48,2,0,2,6,0,1,0,1,42,1,0,1,0,221,3,3,1,0,0,0,0,2,1841,8,0,3,7,0,3,2,12,0,0,7,3,12,6,7,1,0,0,0,1,0,0,3,15,10,0,0,1,3,2,1,0,3,15,6,0,0,18,9,40,0,1,0,3,2,0,0,0,19,0,0,1,12,4,0,2,71,2,0,0,0,117,0,3,2,0,35,9,256,27,0,0,0,254,0,1,3,2,1,2,2,1,0,22,0,6,2,0,10,1,3,0,1,29,21,4,10,2,10,35,0,0,0,0,1,0,0,0,0,6,9,0,8,1,0,9,4,0,6,20,62,0,0,0,0,1,1,0,0,2,2,2,0,19,1,8,1,0,1,32,1,0,6,11,0,0,11,3,66,1,6,4,0,4,20,1,23,1,1,67,69,2,0,5,1,0,0,0,93,1,4,20,10,9,5,0,0,1,0,87,1,2,2,6,0,5,3,1,1,5,0,0,0,0,1,0,11,1,0,0,10,5,6,2,0,3,2,1,1,39,2,1,2,6,0,2,42,0,4,1,4,0,3,0,2,2,0,0,20,0,0,5,18,10,12,16,0,19,0,7,0,0,0,1,2,3,1,2,57,0,0,7,0,8,3,0,1,0,0,0,0,0,1,22,5,0,0,8,9,0,1,0,5,3,2,3,2,1,2,2,1,6,0,3,13,40,5,0,0,0,1,36,0,1,7,2,0,0,2,0,1,0,1,2,1,1,4,1,0,3,7,1,0,0,0,1,5,0,0,2,29,7,0,7,0,0,0,3,0,22,0,1,0,11,0,1,0,3,0,0,2,0,2,10,702,5,5,8,5,6,0,10,1,0,1,3,7,4,3,3,14,7,0,11,0,2,5,0,3,0,6,5,3,4,1,3,2,0,0,1,0,0,1,1,0,0,0,4,0,12,0,1,11,1,3,83,0,0,0,21,14,1,23,0,5,0,6,1,105,0,8,6,1,0,0,6,11,1,2,2,4,4,1,15,4,1,0,1,2,0,0,0,1,0,8,0,10,1,2,0,34,1,3,0,0,0,0,3,1,9,0,2,7,1,0,0,2,0,167,0,2,12,7,4,0,1,1,2,1,1,2,0,12,0,0,1,2,3,18,0,14,6,0,11,0,0,0,2,3,3,0,4,2,0,0,2,0,0,0,0,2,3,0,0,0,19,4,1,1,0,4,0,0,29,1,3,1,0,29,0,0,0,3,0,24,0,0,1,2,0,0,0,0,8,0,0,0,2,1,0,1,1,0,0,20,0,8,11,0,0,1,4,0,0,0,0,0,3,9,7,1,0,0,0,6,0,0,1,5,15,12,3,0,2,5,5,1,0,0,4,13,0,0,0,0,0,25,0,2,0,2,25,1,0,0,4,0,66,4,7,0,0,0,21,0,0,0,0,2,0,0,0,3,0,0,8,10,108,0,13,4,8,1,2,1,2,0,0,1,13,0,3,1,3,1,1,0,5,2,0,1,0,0,0,0,0,3,1,7,2,0,5,0,1,4,0,0,0,6,5,0,0,0,5,2,3,2,1,1,0,0,1,4,0,2,1,12,0,0,4,3,0,0,0,0,1,0,9,1,0,3,0,0,3,4,1,2,1,2,1,14,1,0,0,0,0,7,0,0,0,8,0,0,0,1,1,1,2,0,0,0,0,3,0,0,1,2,0,6,1,4,6,0,0,0,0,0,2,0,0,0,3,0,0,1,0,0,0,0,0,1,4,0,0,0,0,1,1,0,0,1,2,0,0,0,0,1,1,1,1,0,0,0,1,0,7,1,5,3,13,0,13,0,3,0,16,1,0,4,17,0,0,0,13,1,0,3,1,1,0,5,25,4,51,1,0,0,0,4,6,0,3,5,0,0,1,0,1,1,0,29,1,0,3,0,1,1,0,0,19,0,0,1,0,0,0,0,1,0,15,0,0,2,0,0,0,1,0,0,0,0,3,2,5,1,7,1,1,1,0,1,0,0,0,0,1,1,12,0,0,0,10,1,0,0,0,0,3,2,1,0,1,11,9,0,0,0,2,0,1,4,1,0,2,0,0,3,1,1,1,1,4,0,5,0,1,1,3,0,0,1,0,2,2,0,1,1,31,2,0,3,7,1,0,0,1,3,1,1,1,0,0,0,1,0,2,0,0,0,0,0,2,0,4,0,1,0,2,6,1,2,9,12,0,100,8,3,0,1,1,1,1,12,1,0,3,1,0,0,392,2,0,2,12,1,0,2,5,0,0,1,0,1,12,1,0,4,2,1,0,1,2,3,21,2,2,192,3,1,0,1,0,0,0,1,13,1,0,7,0,1,0,2,0,0,0,0,0,0,0,0,1,0,1,0,2,17,0,0,1,0,0,0,0,0,0,0,1,2,2,0,2,1,0,1,1,0,10,0,0,2,112,1,1,0,0,0,0,0,3,4,4,0,0,0,5,0,2,1,5,0,0,4,0,0,0,0,0,0,0,0,1,0,0,0,1,3,1,1,0,0,0,3,3,0,0,1,0,1,4,0,5,1,0,0,0,0,0,0,0,2,2,1,0,0,1,0,0,0,2,1,0,0,1,0,1,1,0,0,0,0,0,0,169,0,6,5,0,4,3,0,3,1,1,1,0,0,0,2,1,3,1,0,0,2,0,6,0,2,0,1,1,3,1,0,4,0,3,0,0,3,115,32,0,6,0,0,0,1,7,0,1,0,0,0,0,2,3,1,3,0,98,0,3,1,0,0,0,0,0,3,0,3,1,16,0,0,4,0,2,0,0,1,0,4,0,1,0,0,0,0,0,0,1,1,0,3,2,3,1,0,0,2,1,0,0,0,0,4,0,0,3,0,0,0,2,0,2,0,4,0,5,0,8,8,0,0,6,1,0,0,0,4,3,0,0,6,0,0,0,1,0,4,0,0,0,0,0,0,0,0,0,1,0,0,0,0,2,0,0,5,0,4,0,1,2,1,1,0,0,0,1,0,3,0,0,0,2,0,0,0,1,0,0,2,2,1,0,1,0,3,2,0,0,0,0,0,0,12,0,0,7,0,0,3,1,0,0,0,0,0,0,0,0,0,0,0,0,17,0,3,1,0,0,1,2,0,0,0,2,30,0,0,0,3,0,2,8,2,3,0,1,0,0,815,0,0,6,0,0,0,0,1,2,0,0,2,1,1,1,4,1,2,0,1,0,0,1,2,0,0,1,2,0,0,0,0,1,0,0,25,3,0,0,3,0,0,3,0,0,9,0,2,4,3,2,0,0,1,1,0,0,0,0,0,0,0,0,0,0,0,1,1,0,0,0,0,0,0,0,0,0,0,1,0,0,0,0,0,0,2,0,1,0,3,1,3,0,0,1,0,1,1,0,0,1,1,0,0,0,1,4,0,0,0,0,1,0,0,0,0,0,3,1,1,0,0,0,4,3,4,0,0,0,1,0,200,3,0,0,0,1,8,0,0,0,0,4,0,4,2,0,2,112,0,0,0,0,0,0,27,0,0,0,0,1,0,0,1,0,1,0,0,0,0,2,0,0,0,0,0,0,0,0,0,0,1,2,0,0,0,0,1,0,135,0,2,1,0,3,0,6,11,1,1,0,0,3,1,1,0,0,0,0,0,0,0,0,2,0,0,5,0,0,0,0,0,1,0,0,0,0,0,476,0,0,0,0,0,0,3,0,0,0,0,1,0,0,1,1,1,0,0,1,0,1,0,0,1,0,0,1,0,0,0,0,0,0,0,0,4,0,0,2,1,0,0,1,0,0,0,1,3,0,0,0,1,0,0,0,0,0,0,7,0,2,0,0,0,2,0,75,12,0,0,0,58,0,6,3,0,0,1,0,0,0,0,0,1,3,0,0,0,10,1,0,2,0,0,0,0,2,0,0,1,0,0,0,0,0,0,0,0,3,0,5,2,0,3,2,0,2,0,0,0,0,0,0,1,0,0,0,0,0,0,0,0,174,0,0,0,0,0,0,0,0,0,0,3,1,0,0,0,0,0,0,0,4,0,2,202,0,1,0,0,0,1,0,0,0,0,0,0,2,0,0,1,0,6,0,0,98,0,0,1,0,1,0,0,0,0,1,0,1,0,0,1,0,0,1,11,0,2,0,0,0,0,0,3,0,4,0,0,0,0,0,1,0,0,0,0,1,2,2,2,0,1,0,0,0,0,3,0,0,0,0,0,0,2,0,0,0,0,0,0,0,0,1,0,2,0,0,0,0,0,0,0,0,0,0,0,0,0,0,0,0,1,1,0,0,0,6,1,1,0,0,1,0,1,1,0,0,7,0,3,0,0,0,0,2,0,0,2,0,0,0,0,0,0,0,0,0,0,0,1,4,0,0,1,6,0,0,1,0,20,0,0,0,0,0,0,0,0,1,1,0,1,0,1,4,0,3,0,0,0,0,0,1,0,0,0,0,0,0,0,4,1,0,0,0,0,8,0,0,0,20,0,0,0,0,1,0,0,0,0,0,0,2,0,52,0,0,1,0,0,0,0,0,0,0,0,1,0,0,1,2,0,0,1,0,0,0,1,0,0,0,1,0,1,0,2,1,0,0,0,0,1,0,0,1,0,0,11,0,2,0,1,0,0,0,0,0,0,0,0,0,2,0,3,0,0,1,0,0,0,0,0,0,27,0,0,0,0,0,0,1,0,0,0,0,0,0,0,0,1,0,0,0,1,0,1,33,0,0,0,0,0,0,0,0,0,0,0,0,5,0,0,0,0,2,0,10,0,0,0,0,0,0,0,1,0,0,0,0,0,0,0,0,0,0,0,0,0,1,0,0,3,0,0,1,0,2,0,0,0,0,0,1,0,0,0,0,0,0,0,0,0,0,0,0,8,0,1,0,0,1,0,0,3,0,0,0,0,0,0,0,2,0,0,0,0,1,0,0,0,0,0,0,0,0,0,0,0,0,0,0,0,0,0,0,0,0,0,0,0,0,0,0,1,0,0,10,1,0,0,0,0,0,1,0,0,0,0,0,0,0,0,0,0,1,0,0,0,0,0,0,125,0,0,0,0,0,0,0,0,0,0,0,0,0,0,0,0,2,4,1,0,0,0,0,0,0,0,0,4,0,0,0,1,0,1,0,1,0,0,0,0,0,0,0,0,0,0,0,0,0,0,3,1,0,0,1,0,1,0,0,0,0,0,0,0,0,0,0,0,0,0,0,0,0,0,0,0,0,0,0,0,1,0,0,0,0,0,0,0,0,0,0,0,0,0,0,0,0,0,0,0,0,0,0,0,0,0,0,0,0,0,14,0,0,0,0,0,0,0,0,0,0,0,0,0,0,0,0,0,0,0,0,0,0,0,0,0,0,0,0,0,1,0,0,0,0,0,1,0,0,0,0,0,0,0,0,0,0,0,0,0,0,0,0,0,0,0,0,0,0,0,0,6,0,0,0,0,0,0,0,0,0,0,0,0,0,0,0,0,0,0,0,0,0,0,0,0,2,0,0,0,0,0,5,0,0,0,0,0,0,0,0,0,0,0,0,0,0,0,0,0,0,0,0,0,0,0,0,0,0,0,0,0,0,0,0,0,0,0,0,0,0,0,0,0,0,0,0,0,0,0,0,0,0,0,0,0,0,0,0,0,0,0,0,0,0,0,0,0,0,0,0,0,0,0,0,0,0,0,0
"Liver Cancer",9916,4265,4654,26628,922,5946,909,844,4644,1643,1021,24284,725,1205,848,1573,8316,2240,1128,31932,2205,717,28246,2054,366,200,4336,1870,3102,234,2738,3265,3691,130,618,3045,1200,368,1652,475,19207,8776,1050,1416,761,2615,109,97,2974,1404,203,207,852,2970,402,554,17993,1367,2207,2578,6073,1688,838,2264,12389,639,116486,1066,163,669,30901,196,635,449,542,2164,165,1811,1442,2600,1572,8200,8157,869,4392,212,3435,648,101,389,247,3935,1153,122,1338,215,443,232,121,529,17465,897,3608,303,292,1421,697,381,154,6861,15058,64,436,1915,380,96,859,11379,10929,522,289,104,121,3079,478,1884,7784,394,457,1151,1226,2126,2182,1012,1011,2332,926,91,925,1060,147,543,315,253,1492,448,548,411,53,508,4473,149,2164,594,536,720,1882,2229,12718,136,64,222,89,52,77,148,3362,765,401,584,2393,52,195,1867,167,100,540,384,358,171,106,3814,2543,568,215,555,126,419,129,307,631,162,175,566,64,619,347,239,147,495,26,18,473,434,72,235,601,3162,47,3785,105,259,4012,619,165,857,1501,76,238,158,597,263,32,171,88,139,395,2792,272,675,142,681,267,38,102,119,801,2202,39,242,205,7,2385,403,30,643,238,79,1046,238,148,121,264,51,276,696,232,663,315,288,326,23,383,5269,1008,32,1385,1284,558,187,268,480,343,213,61,10,353,39,97,583,1367,103,102,3484,25,25,434,55,63,36,32,1,2003,140,77,716,64,99,120,138,81,3366,151,5221,42,5287,184,42,687,48,62,40,866,110,1684,173,35,49,1197,82,176,28,213,162,104,462,1358,83,55,45,559,344,391,63,74,34,46,24,2,1451,971,256,404,148,161,25,149,210,50,33,40,26,32,34,172,175,2535,315,9,133,35,57,415,22,357,949,14,251,16,23,13,3102,4236,43,122,51,51,36,155,4462,222,3032,3016,179,62,57,304,108,28,109,67,297,38,49,17,256,374,19,165,594,382,1696,41,59,427,63,55,216,917,44,49,31,91,802,477,220,17,164,186,43,342,114,220,150,52,38,36,4144,29,72,5,277,178,76,22,25,19,51,10,806,507,9,16,247,56,380,64,332,19,49,43,304,693,409,12,10,59,25,213,97,885,34,8,32,19,299,715,11,9,66,70,238,36,57,209,255,58,149,52,107,11,293,24,490,18,17,34,118,244,17,721,195,304,31,672,50,45,139,16,73,122,16,463,4,5459,39,70,6,669,66,37,404,138,69,10,68,73,403,65,72,67,59,128,131,118,1262,45,117,33,15,26,331,556,826,37,54,197,164,91,588,653,2124,782,13,624,78,113,68,270,545,7,121,20,10,497,124,701,68,101,175,120,42,18,148,40,130,59,24,60,120,142,8,458,403,11,13,127,7,104,26,86,8,177,96,42,54,152,15,6,17,856,27,708,102,41,13,128,107,112,165,59,86,1872,144,378,18,135,36,782,7,144,158,15,68,7,1189,148,34,56,59,231,2310,388,260,25,39,3,91,5,971,737,2,2185,3727,555,33,16,40,109,62,323,5,26,238,514,1496,25,5,83,181,16,80,5,14,0,148,20,232,23,6,13,51,27,54,67,38,22,19,136,250,42,28,30,24,8820,8,43,19,185,51,134,37,487,309,829,70,96,773,235,26,576,185,162,1,251,20,56,12,18,59,184,48,193,47,26,93,64,17,6,39,116,9,104,55,77,281,349,4,7,2688,1347,113,93,4,364,67,64,9,5,22,77,330,99,52,59,64,167,96,4,200,802,33,15,169,62,14,443,11,44,76,460,16,2135,9,41,257,3,17,41,284,33,344,13,72,59,213,187,38,9,157,31,12,28,12,126,58,72,37,741,47,48,562,29,14,2066,6,26,13,31,257,9,14,705,32,106,5,2,10,68,153,26,58,4,36,54,63,9,38,22,36,215,8,65,4,799,4,12,1255,7,17,32,33,54,72,21,39,13,8,0,90,2,223,29,12,260,1600,8,133,9,12,172,14,43,766,54,40,8,7,0,40,29,95,5,361,73,2329,9,316,9,13,11,164,90,82,175,22,12,32,20,200,12,120,9,8,4,184,193,31,17,72,15,38,226,1235,23,7,16,27,0,10,926,24,44,44,1375,133,55,306,153,339,18,22,817,9,9,27,47,62,54,5,16,11,3,47,79,51,112,30,696,42,2,5,511,14,59,44,156,20,265,295,24,881,86,7,14,4,25,9,50,15,7,424,247,477,2,69,143,5,296,8,101,40,68,75,21,4,54,2,16,420,88,61,164,328,259,1,61,8,35,29,16,24,15,28,9,12,112,155,56,35,20,12,0,94,33,113,55,2,74,6,45,55,31,4,249,15,101,0,763,17,56,3,296,72,13,54,132,2234,14,11,103,85,13,204,3,257,39,15,34,0,434,58,13,41,6,11,92,72,43,0,8,16,87,61,9,24,50,290,15,11,0,5,7,43,48,119,8,15,64,109,9,6,19,8,8,1,224,15,99,161,46,17,422,43,0,100,4,0,99,1337,18,11,64,2,13,4,125,21,378,4,41,11,19,517,6,4,3,2,5,3,9,188,348,1,25,17,13,12,42,60,66,105,248,0,1,57,47,1,109,6,4,33,0,17,52,8,19,24,133,13,4,256,333,44,3,0,19,11,60,22,14,609,7,74,0,51,78,1,36,5,29,34,1228,2,62,15,2,20,157,38,1,332,72,37,190,1,25,158,10,22,4,8,38,1510,5,32,52,146,45,0,5,2,8,179,27,8,13,106,20,44,13,0,230,96,164,4,46,15,118,6,3,54,150,3,69,8,1,824,2,10,3,14,54,171,55,32,1,20,5,9,38,34,139,7,1,32,7,210,9,28,3,3,153,13,12,244,211,58,26,9,80,16,190,70,77,6,394,128,3,26,10,2,7,658,353,130,40,25,1240,12,80,13,2,61,1327,16,7,36,4,243,5,1,43,40,269,489,3,155,168,84,17,10,14,0,10,36,314,9,34,19,9,5,4,5,4,60,0,356,28,18,215,18,11,13,365,4,151,2,15,2,693,774,6,23,28,7,2,5,7,31,50,2,14,47,33,53,6,0,4,15,14,5,72,5,6,158,4,76,611,60,52,48,113,8,31,142,9,4,89,0,58,180,13,78,56,66,0,175,45,12,38,6,2,0,7,15,17,9,6,3,142,18,297,60,41,40,576,22,89,2,2,394,0,0,11,9,9,66,2,62,1,7,10,119,7,24,1,105,67,5,3,19,145,385,116,70,2,24,177,33,7,3,9,12,3,0,3,53,23,16,57,65,134,7,27,1,6,2,57,72,13,79,1,27,136,9,11,24,19,31,12,4,31,4,5,22,105,4,6,1,28,31,167,62,20,16,172,15,47,53,2,3,4,93,36,25,24,39,1,27,3,8,12,5,54,30,70,203,10,264,102,0,4,152,13,5,6,13,0,4,10,71,34,92,51,1,95,9,3,24,39,10,48,14,1,48,9,0,16,1,69,93,83,7,19,9,45,15,1,8,3,2,61,0,223,77,166,10,41,3,5,11,48,140,0,1,42,4,43,27,6,30,0,9,4,1,12,13,11,33,26,3,65,3,5,90,2,11,7,61,3,11,1,24,19,32,30,9,1,6,8,4,39,2,48,3,1,1,170,15,100,1,179,16,9,7,0,92,4,79,86,6,90,23,56,119,17,3,5,60,4,126,67,6,2,0,8,9,2,154,1,505,3,2,116,9,36,42,2,188,41,27,27,16,16,239,6,1,4,4,2,3,1,46,0,14,106,4,11,0,7,400,4,245,38,46,54,2,2,3,0,0,19,1,10,33,4,2,2,42,31,80,5,7,155,40,5,7,10,19,6,0,98,34,1308,37,17,48,25,2,179,3,13,25,130,108,311,3,1,35,1,17,0,55,50,2,2,41,20,12,1,3,20,30,4,76,15,17,1,10,1,414,18,11,37,27,12,0,6,1,33,2,347,3,4,2,34,3,101,2,2,14,8,2,2,21,3,4,6,2,3,4,173,1,15,4,27,0,24,0,5,2,0,104,29,108,5,19,258,46,33,370,11,592,5,34,4,0,1,7,10,10,16,0,31,3,1,3,3,25,16,3,4,0,6,28,0,3,7,114,16,1,3,14,7,0,526,6,7,19,5,10,3,1,567,7,0,1,1,2997,12,30,5,3,3,4,66,41,0,1,9,2,3,1,54,2,10,1,0,2,2,7,8,1,9,5,7,89,0,9,7,4,24,2,2,37,31,5,15,5,21,1,0,36,33,183,3,24,144,100,1,111,10,7,0,5,3,0,225,67,134,52,31,75,11,10,3,117,2,1,18,7,122,27,34,5,8,29,3,9,1,12,123,1,51,7,6,23,29,58,2,430,0,36,0,2,4,11,22,1,2,3,26,27,1,102,0,1,41,7,3,272,15,8,27,59,73,12,26,16,849,2,325,2,33,0,25,10,2,2,5,6,63,298,23,11,90,16,17,22,7,17,3,2,3,0,2,15,3,7,6,3,19,2,196,4,17,2,9,39,1,0,16,52,12,31,5,0,17,5,4,1,5,0,96,8,55,12,2,75,2,4,5,12,1,7,40,338,220,3,1,7,2,0,190,1,12,11,0,132,1,3,27,7,45,2,6,22,6,0,43,88,75,0,1,0,8,12,1,0,0,67,20,5,1,0,13,23,4,16,345,7,3,4,21,2,7,8,0,1,209,35,1,17,7,180,7,112,2,24,67,2,1,170,0,0,2,0,1,18,34,1,114,22,1,2,9,0,3,0,1,64,1,573,30,11,8,25,1,1,13,31,1,8,5,38,4,16,5,18,99,2,124,5,4,82,67,0,0,2,9,6,2854,4,11,3,23,13,1,10,2,18,1,85,6,33,1,30,2,5,4,8,197,1,7,0,0,3,18,1,1,515,11,29,6,1514,5,5,11,23,0,6,1,1,4,10,3,5,15,214,3,0,1,16,8,2,1,1,5,2,4,0,2,3,1705,8,5,19,2,2,20,0,2,62,47,14,2,0,2,42,9,2,16,1,72,0,3,1,8,8,71,13,58,16,0,277,1,62,2,10,30,0,0,33,146,2,81,0,6,8,1,30,37,55,2,24,41,5,32,7,0,4,8,2,0,45,13,38,2,28,25,18,3,104,5,0,3,1,19,6,4,12,2,0,27,0,7,3,1,22,0,4,9,18,4,0,6,475,18,10,10,74,0,7,9,6,5,1,27,3,0,12,16,1,4,2,1,11,24,3,11,2,4,13,2,2,0,2,0,4,20,10,11,8,43,4,15,19,2,15,1,65,1,6,5,5,1,0,7,83,6,0,50,4,4,6,356,1,18,74,4,14,3,2,236,2,6,24,25,1,73,2,3,5,7,6,114,22,16,3,1,12,7,9,0,70,0,10,12,8,20,0,2,4,16,49,2,2,24,0,1,34,34,0,4,3,6,153,2,44,0,10,92,1,1,3,0,0,3,3,1,0,35,5,31,0,2,58,0,4,0,0,13,12,12,21,0,2,68,13,0,1,2,5,19,1,3,0,70,1,0,0,11,13,0,0,29,31,7,1,17,6,1,2,1,1,7,14,53,1,1,17,11,208,5,6,31,0,21,1,14,6,67,3,3,2,10,2,0,12,18,73,0,4,15,0,6,4,21,6,1,3,135,52,3,3,0,325,16,0,121,26,22,4,41,3,16,2,10,6,0,5,2,30,2,28,0,0,25,30,6,0,0,40,4,0,4,1,5,115,5,1,4,2,6,0,4,287,3,26,13,9,25,8,0,42,1,6,12,2,1,58,13,4,4,1,64,2,1,296,1,12,0,3,2,4,10,9,0,0,2,14,9,9,0,0,3,2,92,0,35,8,0,11,5,10,158,15,2,33,0,18,2,115,1,2,2,45,15,0,2,5,0,5,0,52,2,9,150,583,0,3,10,0,5,1,8,2,2,8,2,5,211,2,0,4,0,1,1,6,0,6,92,393,1,0,2,2,8,1,0,18,45,14,115,21,3,5,18,0,1,2,0,9,2,0,0,4,1,1,9,5,12,1,1,4,3,3,1,1,3,2,0,10,0,198,1,4,3,101,1,4,11,26,2,2,3,8,4,2,7,1,1,0,13,15,27,1,5,0,3,1,29,0,29,1,0,2,5,8,8,39,2,3,1,0,11,10,60,1,30,0,0,3,8,6,16,1,0,4,2,3,0,2,0,1,6,16,5,102,16,0,1,139,2,3,23,8,9,1,3,0,0,17,0,4,1,2,3,2,7,0,1,4,1,0,0,5,8,13,3,3,5,0,17,2,0,1,4,2,2,0,8,0,36,0,8,10,0,2,2,3,3,19,0,2,0,5,5,0,23,2,2,5,1,0,0,0,13,37,13,2,0,21,0,0,1,4,1,0,2,0,1,0,1,1,2,3,2,0,3,2,28,4,0,0,10,3,1,59,0,2,1,17,0,3,2,3,0,3,6,4,3,4,0,2,1,1,0,5,9,2,3,0,0,0,3,32,1,9,0,0,1,15,35,1,0,531,1,4,7,1,2,9,0,1,2,2,3,20,1,2,0,0,3,2,1,6,1,2,10,7,112,1,4,0,5,16,4,0,2,0,18,2,33,7,0,0,2,0,19,0,24,8,8,0,0,1,6,6,14,0,1,8,1,0,11,4,0,0,5,0,0,0,7,1,4,4,19,1,1,1,0,2,0,0,21,0,4,4,6,0,1,6,0,1,35,1,142,53,5,64,1,2,7,3,1,1,0,11,0,5,0,0,5,0,0,4,0,1,0,0,9,3,1,7,204,0,3,6,0,0,11,57,0,2,2,0,23,4,0,0,0,17,0,5,0,0,3,0,1,0,8,1,0,16,1,2,0,3,3,0,7,2,7,1,0,9,12,0,0,0,6,0,2,28,24,5,7,1,0,0,12,12,2,2,1,1,0,0,0,10,4,2,0,4,9,0,21,4,4,2,9,7,1,0,13,0,2,5,1,6,1,8,2,15,2,21,2,0,1,79,1,1,0,0,4,0,0,1,4,2,16,15,0,8,0,0,10,3,26,3,2,11,1,9,1,9,1,0,16,0,20,0,3,2,0,11,4,0,1,0,17,2,3,0,1,6,22,0,0,10,0,2,3,6,155,0,1,11,13,73,3,3,0,8,4,1,19,0,1,4,0,1,2,4,2,0,0,6,19,2,3,1,6,0,0,24,0,0,0,1,0,1,2,16,0,9,0,4,1,0,13,0,0,0,1,1,9,1,0,0,3,1,0,0,2,28,0,12,5,3,1,3,6,2,0,13,14,2,0,0,11,28,3,0,9,4,0,1,0,0,3,2,67,8,1,3,5,5,0,6,3,0,4,1,0,12,0,0,34,0,0,100,2,0,1,0,0,1,17,7,3,0,82,5,0,0,0,0,18,16,0,4,0,0,5,11,3,3,0,1,1,5,1,0,0,5,12,0,2,0,0,4,4,6,0,0,2,0,0,2,0,0,0,0,17,2,6,0,3,1,9,0,30,1,3,3,0,11,2,0,2,8,3,0,0,3,0,0,2,0,0,0,19,1,1,0,1,0,1,0,12,0,3,0,10,0,7,0,0,32,0,1,14,0,2,0,0,0,1,0,9,16,12,5,3,2,0,1,2,1,1,31,2,0,4,5,2,0,0,16,0,1,11,0,0,7,0,0,0,2,2,0,0,2,1,0,1,0,1,1,0,0,2,11,1,0,0,2,0,3,3,15,5,5,0,1,3,0,0,3,2,3,0,1,0,15,0,0,28,0,2,38,0,12,0,0,6,127,5,2,8,2,0,0,1,0,3,2,2,3,7,4,0,10,1,0,4,16,58,2,0,1,1,0,2,1,0,0,5,4,154,3,0,2,0,0,7,17,1,1,1,2,0,1,0,4,0,0,2,9,1,0,0,0,0,17,1,0,0,6,0,0,0,0,1,0,4,17,1,5,0,0,1,13,0,0,8,13,1,0,3,0,0,4,0,6,0,0,0,5,8,0,3,0,0,1,2,7,0,6,1,0,11,13,1,0,1,0,0,0,0,1,4,2,0,0,5,1,1,68,0,12,0,2,0,7,0,0,0,0,3,0,8,3,4,2,2,0,1,6,1,0,6,0,0,5,75,14,1,1,0,2,0,5,0,70,0,0,6,0,0,0,29,0,38,23,0,4,14,1,10,1,0,69,0,0,0,0,2,0,0,0,0,6,14,1,0,1,19,0,5,0,0,2,0,0,0,0,2,0,3,0,0,0,0,0,8,5,1,0,2,3,0,33,1,2,1,1,0,0,0,0,0,2,0,0,0,0,0,0,3,0,1,1,5,1,24,3,0,0,0,1,0,3,0,0,0,0,1,2,2,32,2,0,0,31,0,1,2,0,0,0,0,0,0,0,0,7,0,0,0,0,0,1,0,2,0,0,0,0,6,0,0,0,0,1,1,0,0,30,0,0,0,0,1,4,0,0,0,0,0,0,0,0,0,0,2,1,0,1,3,57,0,2,0,11,8,0,0,0,1,0,1,0,0,0,13,1,4,2,0,0,0,0,0,0,1,0,28,0,1,0,0,1,1,0,0,0,0,0,1,0,4,0,1,1,0,0,0,0,0,1,0,0,2,0,4,0,0,1,1,0,0,1,0,2,1,1,2,0,1,0,0,0,2,0,0,0,0,0,0,3,0,0,0,0,0,0,1,0,0,2,1,0,0,4,0,1,2,1,1,0,1,0,3,1,0,0,0,0,4,3,0,0,0,1,0,0,0,0,0,1,1,6,0,0,1,1,1,25,0,0,1,0,4,8,0,0,2,0,0,1,0,0,0,0,0,0,0,0,2,0,0,1,0,0,1,0,0,0,0,0,1,0,2,0,1,0,3,0,0,1,10,0,0,0,0,1,0,0,0,0,0,0,0,0,0,0,0,0,0,0,0,0,0,2,0,0,0,0,0,0,2,0,0,0,1,0,2,3,0,0,0,0,1,1,1,0,0,1,3,2,0,0,1,0,4,0,0,0,0,0,0,0,0,0,0,0,0,0,0,0,0,2,0,0,1,0,0,0,4,2,0,0,0,0,0,1,0,0,1,0,0,1,0,0,0,0,0,0,1,0,0,0,2,0,0,0,0,0
"Lower Grade Glioma",125,2,6,297,1,35,4,30,4,2,2,1,1,6,2,0,56,4,4,7,4,1,50,3,1,1,13,0,8,0,3,7,1,10,1,5,0,3,1,0,76,34,84,1,8,65,1,6,23,0,51,0,0,4,1,1,1,0,21,8,70,0,0,2,153,1,40,4,8,2,0,60,0,1,1,2,0,21,2,5,28,19,12,3,9,0,8,0,0,1,8,14,0,2,2916,0,3,0,1,0,0,1,0,0,6,0,0,26,0,5,0,0,1,2,1,4,1,0,0,1,0,0,4,16,0,5,66,0,0,0,0,13,15,0,7,5,109,2,26,0,0,10,0,0,3,0,0,6,0,2,37,0,13,0,0,1,6,11,1,3,0,0,1,1,0,5,58,0,1,0,11,0,1,0,0,4,5,0,0,0,0,6,15,0,1,6,0,0,2,1,0,14,1,1,0,10,0,1,0,0,0,0,0,0,0,0,1,57,0,49,0,0,15,0,0,1,0,1,0,4,0,1,0,0,0,4,0,58,0,0,0,54,1,0,0,0,0,4,0,2,2,0,1,1,0,0,0,0,4,0,9,0,0,0,3,1069,2,3,0,12,4,0,0,0,0,1,9,3,70,0,1,961,1,0,0,0,0,0,0,28,5,5,0,0,0,0,5,1,1,1,0,0,2,0,0,0,0,1,0,0,0,0,1,5,0,5,2,0,5,0,1,0,6,0,2,3,0,0,29,0,1,0,0,0,1,7,0,0,1,0,0,0,17,0,0,1,0,0,0,2,2,0,2,0,1,0,0,0,18,0,1,1,1,1,0,0,0,0,0,1,0,0,0,0,0,0,0,10,1,0,1,15,0,0,49,0,0,0,1,0,0,0,0,0,1,0,1,0,0,0,0,4,0,0,0,0,0,0,0,0,0,0,2,0,2,0,0,0,13,0,0,1,71,0,0,17,0,0,0,0,1,0,0,0,0,0,0,0,0,0,1,0,0,0,1,1,1,0,0,3,0,0,0,0,0,0,0,2,0,0,0,0,2,1,0,1,0,0,0,0,0,0,0,1,0,45,22,4,0,0,1,0,0,0,17,0,0,0,0,0,0,1,0,3,0,0,0,0,88,0,4,0,0,0,0,0,0,0,0,0,1,0,1,1,0,0,0,0,15,0,0,0,1,0,0,0,0,1,0,0,0,9,0,0,0,17,0,0,0,0,0,0,4,15,3,0,2,0,0,14,2,0,1,0,15,4,0,1,0,0,0,0,0,0,0,0,0,0,2,15,0,3,0,0,0,1,0,0,0,0,0,0,0,1,0,0,1,0,0,0,0,0,0,2,0,0,0,0,7,0,0,1,0,0,1,0,0,0,0,0,0,0,3,0,0,0,0,0,0,0,0,0,0,0,0,3,0,0,0,0,0,0,0,0,0,0,0,0,0,0,24,0,1,0,0,0,0,0,0,0,0,0,0,1,22,0,10,0,0,0,0,0,1,0,0,0,0,0,0,0,0,0,1,0,2,0,0,0,3,0,0,0,1,0,17,0,0,0,0,0,0,4,0,1,0,0,0,2,0,0,3,10,1,0,0,0,0,0,0,0,0,0,1,0,0,0,0,0,0,0,0,1,1,0,0,11,0,0,0,0,0,0,0,0,0,0,0,0,0,16,0,0,1,0,0,0,0,0,0,1,0,2,1,0,0,0,1,0,0,0,0,0,0,0,0,1,1,0,0,0,0,0,2,0,2,0,0,0,0,0,0,0,0,0,0,0,0,0,0,0,0,3,0,0,0,0,0,0,0,1,0,0,2,0,0,0,0,0,1,0,0,0,0,0,0,0,0,0,0,0,0,0,0,0,0,1,0,0,0,0,0,0,0,0,0,0,0,1,0,0,0,0,0,0,0,1,0,0,0,1,0,0,0,2,0,0,0,0,0,0,0,0,0,0,0,0,0,1,1,0,0,1,0,0,1,0,0,0,0,0,0,7,0,0,0,0,11,1,0,0,0,0,1,0,0,0,0,0,0,1,1,0,0,0,0,0,1,1,1,0,0,0,0,0,0,0,0,2,0,0,0,0,0,0,0,5,0,0,1,0,0,0,27,0,1,0,1,0,15,3,7,0,1,0,0,0,7,0,1,0,0,2,0,4,0,0,0,0,6,0,1,0,0,0,2,0,0,0,0,0,0,0,2,0,4,0,0,0,0,0,0,0,0,0,0,0,9,5,0,0,0,0,0,1,0,0,0,0,0,0,0,0,0,0,0,0,0,0,0,0,0,0,0,0,0,0,0,0,0,0,0,5,3,0,0,2,0,0,0,0,0,0,0,0,0,0,0,0,0,0,1,1,0,0,0,0,0,1,0,0,0,0,0,0,0,57,0,1,0,0,0,0,0,0,0,0,0,0,1,0,0,0,0,0,0,0,0,0,2,0,0,1,0,0,0,0,0,0,0,0,0,0,0,0,0,0,0,0,0,0,0,1,0,0,0,6,0,0,0,0,0,0,0,0,0,0,0,0,0,0,0,0,0,0,0,0,0,0,0,3,0,0,1,0,0,0,0,0,0,0,1,13,0,0,0,0,0,0,0,0,0,0,1,1,0,0,0,0,1,0,0,1,0,0,0,0,0,0,0,0,0,0,0,0,3,0,0,1,0,0,0,0,0,0,0,0,0,0,0,0,0,0,0,0,0,1,1,0,0,0,0,0,0,0,0,0,0,0,0,1,0,0,0,0,0,0,0,0,0,0,0,17,0,0,0,0,0,1,0,0,0,0,0,1,0,0,0,0,0,0,0,0,0,0,1,0,1,0,0,0,0,0,0,0,0,0,0,0,0,0,0,0,0,0,0,0,0,1,0,1,0,0,0,0,0,0,0,0,0,0,1,0,0,0,0,0,0,0,0,0,0,0,0,0,0,0,0,38,4,0,0,0,0,0,4,0,0,0,1,0,0,11,0,0,0,1,0,0,0,0,0,0,0,0,0,0,0,0,0,0,0,0,0,0,0,0,0,1,0,96,0,0,0,0,0,0,0,0,0,0,0,0,0,0,0,0,0,0,0,0,0,0,0,0,0,0,3,0,0,0,0,0,1,0,0,0,0,0,0,0,0,0,0,0,0,0,0,1,0,1,0,0,0,0,1,0,0,1,0,0,0,0,2,0,1,0,0,0,0,0,0,0,0,0,0,0,0,0,0,0,0,0,0,0,0,0,0,0,0,0,0,5,0,0,0,0,0,0,0,0,0,0,0,0,0,0,2,0,0,0,0,0,0,0,0,2,0,0,0,0,0,0,0,0,0,0,0,0,1,0,0,0,0,0,0,0,0,2,0,1,0,0,0,0,1,0,0,0,0,1,0,0,8,0,0,0,0,0,1,0,0,0,1,0,0,0,0,0,0,0,0,0,0,0,0,0,0,0,0,0,0,0,0,0,0,0,0,0,0,0,0,0,0,13,0,0,0,0,0,0,0,0,0,0,0,0,0,0,0,0,0,0,0,0,0,0,0,0,0,0,0,0,0,0,0,0,0,0,0,0,0,0,0,0,0,0,0,0,0,0,1,0,0,0,0,0,0,0,0,0,0,0,3,0,0,0,0,0,1,0,0,0,0,0,0,0,0,0,0,0,0,0,2,0,0,0,0,0,0,0,228,0,0,1,0,0,0,0,0,0,0,0,0,4,0,0,0,0,0,0,0,1,0,0,0,0,0,0,0,0,0,1,0,0,0,0,0,0,1,0,0,0,0,0,0,0,0,0,0,0,0,0,0,0,0,0,0,0,0,0,0,0,0,0,0,0,10,1,2,0,0,0,0,0,0,0,0,0,0,0,0,0,1,0,0,0,0,0,2,0,0,0,0,0,0,0,0,0,0,0,0,0,0,0,0,0,0,0,2,1,0,0,0,0,0,1,0,0,0,0,0,0,0,0,0,0,0,0,0,0,0,0,0,0,0,0,0,0,0,0,0,34,0,1,0,0,0,0,0,0,0,0,0,0,0,0,0,0,0,0,0,0,0,0,0,0,0,0,0,0,1,0,0,0,0,0,0,0,0,0,0,0,1,0,0,0,0,0,0,0,1,0,0,0,0,0,0,0,0,0,0,0,0,0,0,0,0,0,0,0,0,0,0,0,0,0,0,0,0,0,0,0,0,0,0,1,0,0,0,0,0,0,0,0,0,2,0,0,0,0,0,0,0,0,0,0,0,0,0,1,1,1,0,0,1,0,0,0,0,0,0,0,0,6,0,0,0,0,0,0,0,0,0,0,0,0,0,0,0,0,0,0,0,0,0,0,0,0,0,0,0,0,0,0,0,0,0,0,0,0,0,0,1,0,0,0,2,0,0,0,0,0,0,0,0,0,0,0,0,0,0,0,0,0,0,0,0,1,0,0,0,0,1,0,0,0,0,0,0,0,0,0,0,0,0,0,0,0,0,0,0,0,0,0,0,0,0,1,0,0,0,0,0,0,10,0,0,0,0,0,0,0,0,0,0,0,0,0,0,0,0,0,0,0,0,1,0,0,0,0,0,0,0,0,0,0,0,0,0,0,0,0,0,0,0,0,0,0,0,0,0,1,0,0,0,0,0,0,0,0,0,0,0,0,0,0,0,0,0,0,2,0,0,0,0,0,0,0,0,0,0,0,0,6,0,0,0,2,0,0,0,0,0,0,0,0,0,3,0,0,0,0,0,0,0,0,0,0,0,0,0,0,0,0,1,0,0,0,0,0,0,0,0,0,0,1,0,0,0,0,0,0,0,0,0,0,0,0,0,0,0,0,0,0,0,0,0,0,0,0,0,0,0,0,0,0,0,0,0,0,0,0,1,0,0,0,0,0,0,0,0,0,0,0,0,1,0,0,0,1,0,0,0,0,0,0,0,0,0,1,0,1,0,0,0,0,0,1,0,0,0,0,0,0,0,0,0,0,0,0,0,0,0,0,0,0,0,0,0,1,0,0,0,0,0,0,0,0,0,0,0,0,0,0,0,0,0,0,0,0,0,0,3,0,0,0,0,0,0,0,0,0,0,0,0,0,0,0,0,0,0,0,0,0,0,0,0,0,0,0,0,0,0,0,0,0,0,0,1,0,0,0,0,0,0,0,0,0,0,0,0,0,0,0,0,0,0,0,0,0,0,0,0,0,0,0,0,0,0,0,0,0,0,0,0,0,0,0,0,0,0,0,0,0,0,0,0,0,0,0,0,0,0,0,0,0,0,0,0,0,0,0,0,0,0,1,0,0,0,1,0,0,0,0,0,0,0,0,0,0,0,0,0,0,0,0,14,0,0,0,0,0,0,0,0,0,0,0,1,0,0,0,0,0,0,0,0,0,0,0,0,0,0,0,0,0,0,0,0,0,0,0,0,0,0,0,0,0,0,0,0,0,0,0,0,0,0,0,0,0,0,0,0,0,0,0,0,0,0,1,0,0,1,0,1,0,0,0,0,0,0,0,0,0,0,0,0,0,0,0,0,0,0,0,0,0,0,0,0,0,0,0,0,0,0,0,0,0,0,0,0,0,0,0,0,1,0,0,0,0,0,0,0,0,0,0,0,0,0,0,0,0,0,0,0,0,0,0,0,0,0,1,0,0,0,0,1,0,2,0,0,0,1,0,0,0,0,0,0,0,0,0,0,0,0,0,0,0,0,9,0,0,0,0,0,0,0,0,0,0,0,0,0,0,0,0,0,0,0,0,0,0,0,0,0,0,0,0,0,0,0,0,0,0,0,0,0,0,0,0,0,0,0,0,0,1,0,0,0,0,0,0,0,0,0,0,0,0,0,0,0,0,0,0,0,0,0,0,0,0,0,0,0,1,0,0,0,0,0,0,0,0,0,0,0,0,0,0,0,0,0,0,0,0,0,0,0,0,0,0,0,0,0,0,0,0,0,0,0,0,0,0,0,0,0,0,0,0,0,0,0,0,0,0,0,0,0,0,0,0,0,0,0,0,0,0,0,0,0,0,0,0,0,0,0,0,0,0,0,0,0,0,0,0,4,0,0,0,0,0,0,0,0,0,0,0,0,0,0,0,26,0,2,0,0,0,0,0,0,0,0,0,0,0,0,0,0,0,13,0,0,0,0,0,0,0,0,0,3,0,0,0,0,0,0,0,0,0,0,0,0,0,0,0,0,0,1,0,0,0,0,0,0,0,0,0,0,0,0,0,0,0,0,0,0,0,0,0,0,0,0,1,0,0,0,0,0,0,0,0,0,0,0,0,0,0,0,0,0,0,0,0,0,1,0,0,0,0,0,0,1,0,0,0,0,0,0,0,1,0,0,0,0,2,0,0,0,0,0,0,0,0,0,0,0,0,0,0,0,0,0,0,0,0,0,0,0,0,0,0,0,0,0,0,0,0,0,0,0,0,0,0,0,0,0,0,0,0,0,0,0,0,0,0,0,0,0,8,0,0,0,0,0,0,0,0,1,0,0,0,0,0,0,0,0,0,0,0,0,0,0,0,0,0,0,0,0,0,0,0,0,0,0,0,0,0,0,0,0,0,0,0,0,0,0,0,0,0,0,0,0,0,0,0,0,0,0,0,0,0,0,0,0,0,0,0,0,0,0,0,0,0,0,0,0,0,0,0,0,0,0,0,0,0,0,0,0,0,0,0,0,0,0,0,0,0,0,0,0,0,0,0,0,0,0,0,0,0,0,0,0,0,0,0,0,0,0,0,0,0,0,0,0,0,1,0,0,0,0,0,0,0,0,0,0,1,0,0,0,0,0,0,0,0,0,4,0,0,0,0,0,0,0,0,0,0,0,0,0,0,0,0,0,0,0,0,0,0,0,0,0,0,0,0,0,0,0,0,0,0,0,0,0,0,0,0,0,0,0,0,0,0,0,0,0,0,0,0,0,0,0,0,0,0,0,0,0,0,0,0,5,0,0,0,0,0,0,0,0,0,0,0,0,0,1,0,0,0,0,0,0,0,0,0,0,0,0,0,0,0,0,0,0,0,0,0,0,0,0,0,0,0,0,0,0,0,0,0,0,0,0,0,0,0,0,0,0,0,0,0,0,0,0,0,0,0,0,0,0,0,0,1,0,0,0,0,0,0,0,0,0,2,0,0,4,0,0,0,0,0,0,0,0,0,0,0,0,0,0,0,0,0,0,0,0,0,0,0,0,1,0,0,0,0,0,0,0,0,0,0,0,0,0,0,0,0,0,0,0,0,0,0,0,0,0,0,0,0,0,0,0,0,0,0,0,0,0,11,0,0,0,0,0,0,0,0,0,0,0,0,0,0,0,0,0,0,0,0,0,0,0,0,0,0,0,0,0,0,0,0,0,0,0,0,0,0,0,1,0,0,0,0,0,0,0,0,0,0,0,0,0,0,0,0,0,0,0,0,0,0,0,0,0,0,0,0,0,0,0,0,0,0,0,0,0,1,1,0,0,0,0,0,0,0,0,0,0,0,0,0,0,0,0,0,0,0,0,0,0,0,0,0,0,0,0,0,0,0,0,0,0,0,0,0,0,0,0,0,0,0,0,0,0,0,0,0,0,0,0,0,0,0,0,0,0,0,0,0,0,0,0,0,0,0,0,0,0,0,0,0,0,0,0,0,0,0,0,0,0,0,0,0,0,0,0,0,0,0,0,0,0,0,0,0,0,0,0,0,0,0,0,0,0,0,0,0,0,0,0,0,0,0,0,0,0,0,0,0,0,0,0,0,0,0,0,0,1,0,0,0,0,0,0,0,0,0,0,0,0,0,0,3,0,0,0,3,0,0,0,0,0,0,0,0,0,0,0,0,0,0,0,1,0,0,0,0,0,0,0,0,0,0,0,0,0,0,0,0,0,0,0,0,0,0,0,0,0,0,0,0,0,0,0,0,0,0,0,0,0,0,0,0,0,0,0,0,0,0,0,0,0,0,0,0,0,0,0,0,0,0,0,0,0,0,0,0,0,0,0,0,0,0,0,0,0,0,0,0,0,0,0,0,0,0,0,0,0,0,0,0,0,0,0,0,0,0,0,0,0,0,0,0,0,0,0,0,0,0,0,0,0,0,0,0,0,0,0,0,0,0,0,0,0,0,0,0,0,0,0,0,0,0,0,0,0,0,0,0,0,0,0,0,0,0,0,0,0,0,0,0,0,0,0,0,0,0,0,0,0,0,0,0,0,0,0,0,0,0,0,0,0,0,0,0,0,0,0,0,0,0,0,0,0,0,0,0,0,0,0,0,0,0,0,0,0,0,0,0,0,0,0,0,0,0,0,0,0,0,0,0,0,0,0,0,0,0,0,0,0,0,0,0,0,0,6,0,0,0,0,0,0,0,0,0,0,0,0,0,0,0,0,0,0,0,0,0,0,0,0,0,0,0,0,0,0,0,0,0,0,0,0,0,0,0,0,0,0,0,0,0,0,0,0,0,0,0,0,0,0,0,0,0,0,0,0,0,0,0,0,0,0,0,0,0,0,0,0,0,0,0,0,0,0,0,0,0,0,0,0,0,0,0,0,0,0,0,0,0,0,0,0,0,0,0,0,0,0,0,0,0,0,0,0,0,0,0,0,0,0,0,0,0,0,0,0,0,0,0,0,0,0,0,0,0,0,0,0,0,0,0,0,0,0,0,0,0,0,0,0,0,0,0,0,0,0,0,0,0,0,0,0,0,0,0,0,0,0,0,0,0,0,0,0,0,0,0,0,0,0,0,0,0,0,0,0,0,0,0,0,0,0,0,0,0,0,0,0,0,0,0,0,0,0,0,0,0,0,0,0,0,0,0,0,0,0,0,0,0,0,0,0,0,0,0,0,0,0,0,0,0,0,0,0,0,0,0,0,0,0,0,0,0,0,0,0,0,0,0,0,0,0,0,0,0,0,0,0,0,0,0,0,0,0,0,0,0,0,0,0,0,0,0,0,0,0,0,0,0,0,0,0,0,0,0,0,0,0,0,0,0,0,0,0,0,0,0,0,0,0,0,0,0,0,0,0,0,0,0,0,0,0,0,0,0,0,0,0,0,0,0,0,0,0,0,0,0,0,0,0,0,0,0,0,0,0,0,0,0,0,0,0,0
"Lung Adenocarcinoma",1294,187,360,4495,182,507,324,166,103,1016,170,869,120,269,128,202,2515,58,942,126,317,140,8443,45,33,66,359,142,497,68,405,445,72,34,98,164,89,137,136,46,2919,1455,328,47,137,636,66,26,335,111,24,34,46,485,38,81,31,47,778,235,1506,80,80,64,2092,56,801,85,89,33,52,60,34,167,145,57,17,329,34,489,235,17947,1629,163,772,14,336,34,10,126,115,636,245,8,379,43,58,13,22,67,30,382,243,11,34,12,86,156,54,3253,29,25,28,37,48,33,45,27,31,36,587,17,42,17942,380,157,2267,37,456,80,24,442,308,747,114,152,253,39,124,33,22,187,46,29,152,37,11,119,9,64,777,35,455,55,142,38,12545,14747,142,89,16,38,18,14,16,42,702,20,181,46,504,18,180,74,20,72,15,54,179,24,42,902,726,40,25,52,9,8,17,72,725,40,44,130,16,108,673,8,52,124,7,0,9,18,4,31,322,1092,11,62537,8,30,573,77,46,143,60,12,72,77,79,17,12,88,19,81,567,486,18,30,28,196,27,7,7,32,20,1228,12,8,54,0,113,41,20,175,30,33,81,57,69,69,18,15,74,322,8,91,38,137,81,12,49,179,92,8,365,171,138,6,71,140,8,21,3,8,6,7,5,458,172,25,16,69,12,14,173,11,4,6,12,4,560,97,5,36,11,14,87,137,5,20,27,140,12,142,24,2,44,19,26,5,262,58,104,72,78,16,1049,0,14,5,23,16,14,79,11,4,4,6,33,217,69,11,6,13,10,6,0,242,162,54,40,8,61,16,6,44,28,5,9,6,6,7,11,35,8,37,11,9,6,11,59,2,29,1375,10,81,5,3,9,4511,10,6,23,15,17,3,109,5,207,33,6,24,1,9,13,30,1,6,14,48,1,12,5,24,11,5,22,23,45,25,16,7,94,4,29,30,126,42,13,7,89,324,9,9,12,4,45,2,78,34,263,15,4,3,7,4,13,29,0,28,35,6,15,13,2,13,6,17,4,0,10,155,10,15,2,5,5,3,12,88,242,32,3,0,2,2,19,7,22,5,1,3,6,66,179,1,7,14,45,58,7,19,32,87,34,20,5,4,1,33,7,121,8,6,12,10,113,5,81,13,5,7,255,6,8,92,1,12,27,3,146,3,6,1,13,1,57,27,6,52,11,30,3,25,66,67,4,66,1,10,31,67,1,205,4,168,13,12,2,19,120,519,6,15,45,2,17,200,237,19,52,0,59,21,21,14,35,4,5,6,2,2,156,16,24,7,9,30,11,17,3,19,7,17,35,4,4,84,15,3,115,38,1,5,11,1,2,2,11,2,7,50,17,2,5,3,1,3,20,10,12,29,16,1,20,7,163,131,3,1,193,14,4,3,23,6,18,5,34,4,2,9,11,258,4,32,2,12,37,21,27,140,2,26,3,10,1,5,1770,2,826,7,2,27,18,6,8,37,76,7,6,11,884,22,20,1,7,6,2,6,6,6,0,11,15,2,1,1,1,13,16,1,32,4,8,3,50,45,17,0,17,8,127,2,10,1,18,16,51,22,34,81,144,17,5,215,11,19,112,32,48,0,12,5,8,4,3,10,26,7,8,4,3,4,12,3,1,1,6,3,11,3,2,357,22,3,3,21,5,38,2,1,74,13,7,0,0,4,51,10,26,3,67,29,19,2,2,81,7,20,21,53,1,2,60,0,2,1,43,5,545,3,1,26,1,13,4,17,10,58,6,24,15,35,18,7,0,96,7,10,1,2,239,7,5,2,1262,3,2,93,13,1,2,12,5,3,78,41,4,6,96,19,6,4,0,1,12,10,54,32,1,4,2,9,4,13,2,22,8,1,4,1,4,5,6,371,4,9,4,10,10,157,2,4,0,2,0,5,2,5,1,2,39,336,4,281,1,3,15,0,1,66,0,16,7,1,0,1,1,64,1,3,10,19,0,102,8,2,0,16,40,109,33,4,1,4,7,14,0,15,0,7,0,11,31,7,9,10,0,6,20,3,0,1,12,4,0,13,103,12,11,15,9,9,18,54,14,17,0,20,11,0,6,7,21,38,64,0,8,4,3,1,63,16,117,0,102,38,0,4,127,3,30,4,43,0,163,52,8,51,7,4,19,2,2,5,9,5,4,60,11,58,0,3,7,1,69,1,10,0,16,2,5,0,47,0,2,31,51,3,33,35,521,0,12,1,30,10,4,1,14,4,2,2,15,77,10,1,0,6,0,6,2,33,23,0,3,1,6,9,7,2,4,9,5,0,4,2,139,4,33,5,0,15,61,3,2,1,28,16,0,14,1,29,15,5,1,0,15,4,2,4,1,1,45,12,1,1,1,9,4,48,1,8,15,80,2,3,0,0,1,1,128,26,1,2,17,3,2,1,12,1,0,1,13,8,57,3,3,0,86,15,0,3,0,0,19,40,0,4,17,0,8,1,34,16,51,3,122,4,3,68,1,0,1,0,12,0,2,31,53,1,6,8,5,2,8,10,3,5,1,0,0,8,129,1,4,2,2,2,0,20,18,0,27,5,3,5,1,15,127,67,2,0,1,1,0,6,0,132,0,17,3,3,0,0,8,0,0,7,9,5,1,1,0,31,19,64,1,2178,94,8,43,0,2,31,2,7,2,2,7,3,0,1,1,8,7,0,2,0,12,15,1,0,7,5,1,17,2,0,54,25,22,1,7,17,18,1,2,5,172,5,14,0,0,22,5,3,1,3,3,22,9,3,0,7,1,1,5,4,7,2,0,5,0,8,27,10,1,2,150,6,1,812,33,17,3,3,13,4,26,19,12,3,14,3,4,2,0,0,2,40,93,8,3,0,9,4,1,6,1,102,62,16,1,23,3,22,0,0,72,0,0,15,2,21,20,5,4,1,4,2,1,0,2,1,16,21,0,3,5,0,2,16,0,1183,11,5,65,3,0,4,125,0,3,1,6,2,1,189,3,5,4,8,1,1,0,11,43,0,1,0,5,1,0,0,2,0,0,0,6,1,0,5,0,197,1,10,109,3,3,4,2,8,0,0,10,1,8,25,3,25,2,13,0,5,0,0,71,0,0,0,0,6,19,0,1,0,7,0,40,4,2,5,2,3,16,0,6,56,0,0,11,1,1,39,1,1,0,1,6,17,9,6,5,91,15,2,1,13,15,2,55,13,0,6,32,3,0,1,2,1,1,2,2,0,8,9,21,2,0,4,3,0,3,0,4,6,9,14,0,25,40,12,1,3,3,7,14,0,3,0,1,0,464,0,3,0,6,22,0,1,0,13,7,4,2,2,3,1,2,7,3,3,5,14,0,1,0,0,0,4,16,3,10,20,1,272,5,6,0,43,0,1,1,8,0,2,6,19,3,8,8,0,15,2,10,8,5,1,14,9,1,3,7,0,0,1,1,10,4,1,0,1,3,1,0,2,0,2,3,0,0,118,2,4,1,2,0,0,1,91,0,1,2,1,2,2,5,2,2,10,1,0,1,1,2,2,11,0,0,1,4,6,0,0,1,573,3,0,0,9,37,3,2,0,0,0,0,0,1,0,5,0,0,0,61,0,21,0,78,0,0,0,0,6,1,1,2,2,26,4,9,17,0,0,0,4,1,3,109,4,1,2,12,0,0,12,0,3,2,0,21,0,2,2,0,25,8,8,6,7,0,37,1,0,8,1,2,0,1,9,0,12,12,0,21,1,0,453,2,10,2,18,4,1,0,1,1,0,20,1,1,2,1,1,0,18,85,9,0,0,0,7,0,1,4,3,0,0,12,0,35,1,3,11,0,3,25,0,0,1,2,3,109,0,1,1,0,1,0,1,11,2,6,2,3,1,2,0,0,2,3,88,0,2,4,3,0,5,2,2,5,10,0,0,1,0,0,1,32,12,0,2,33,7,7,1,0,0,15,1,2,4,0,1,2,2,1,2,441,2,3,0,4,0,3,0,1,0,0,0,47,9,0,2,206,3,0,68,0,94,0,0,3,0,3,1,2,4,1,0,8,1,0,3,2,5,2,1,1,1,0,1,0,0,3,27,4,0,1,3,0,0,3,0,0,3,0,5,0,0,14,0,0,1,3,11,7,3,1,0,0,2,3,7,0,0,3,0,0,0,2,0,0,0,0,2,1,1,4,0,0,6,3,1,0,0,0,0,6,0,3,5,8,3,1,2,0,0,0,3,0,13,0,8,1,9,0,6,1,0,0,0,4,0,750,110,6,1,18,5,14,1,0,18,0,0,6,10,178,69,1,2,3,25,0,13,1,2,75,0,8,0,4,4,9,12,0,3,1,5,0,0,0,1,0,0,0,0,0,1,0,8,0,2,4,2,7,83,1,2,1,75,44,2,8,3,25,2,48,1,5,0,11,6,0,0,2,10,5,2,4,3,8,3,4,10,1,1,7,1,0,0,0,9,0,3,2,1,16,1,2,1,2,2,2,0,0,0,0,5,4,1,0,1,2,6,0,0,0,0,24,3,0,1,1,9,0,1,2,0,0,2,6,2,19,0,1,4,1,0,0,0,1,0,0,5,0,0,9,6,3,0,1,2,5,0,4,12,8,0,1,0,5,7,0,0,0,4,6,0,0,0,5,0,1,1,0,5,5,2,7,0,1,1,1,0,167,2,0,2,0,3,0,2,0,2,2,1,0,18,0,0,0,0,0,0,9,1,8,3,2,0,5,3,0,0,2,1,1,31,2,8,1,1,0,1,1,1,1,0,1,17,1,0,0,0,5,1,0,0,1,24,18,0,0,0,1,0,66,1,1,0,2,3,0,0,0,1,0,5,3,7,0,2,0,2,0,1,16,0,3,0,0,2,5,0,0,16,1,3,3,21,4,8,19,2,0,0,0,0,3,4,0,0,2,2,1,0,0,2,1,0,0,0,0,0,0,0,5,4,3,0,0,13,2,0,8,0,1,1,4,7,0,0,0,0,3,0,19,0,0,0,0,0,11,2,4,2,2729,2,0,233,2,2,0,0,32,0,0,11,34,0,26,1,0,1,1,26,3,14,0,1,1,0,1,0,0,1,8,0,0,1,5,2,0,2,3,0,2,8,0,0,0,0,1,1,1,0,2,0,2,1,1,0,5,0,0,0,0,3,1,0,0,12,2,2,1,2,0,0,0,3,0,2,4,2,0,0,3,0,2,2,0,8,0,0,1,1,1,2,0,6,0,0,0,0,0,7,1,0,28,0,0,1,0,2,0,3,0,0,3,1,0,0,0,23,2,1,16,1,2,0,18,6,1,22,1,1,1,0,2,2,0,7,2,1,0,0,0,0,27,0,53,0,0,1,0,4,2,0,0,8,0,3,0,0,1,1,0,3,1,17,0,2,0,0,2,0,0,2,0,13,3,13,0,63,0,3,1,3,4,0,2,1,0,0,0,0,5,24,1,0,1,7,1,0,0,0,0,1,1,0,0,0,7,2,0,0,1,3,0,0,0,4,7,2,0,0,3,1,0,0,9,9,0,2,2,3,0,2,0,0,0,2,14,1,0,1,7,13,1,1,0,3,6,0,0,0,0,0,0,0,1,0,0,13,1,11,0,2,2,1,0,2,0,37,0,0,25,5,0,0,0,3,3,2,8,4,2,1,20,3,0,0,2,2,0,1,0,1,0,42,3,0,125,4,2,0,0,5,0,0,2,3,1,47,3,0,0,1,0,0,1,3,2,4,1,9,4,4,0,1,0,2,17,0,0,7,2,0,4,0,17,0,2,0,0,8,0,0,0,0,0,1,0,1,0,2,8,1,0,1,0,3,0,2,1,1,0,3,2,0,46,7,0,1,0,0,0,67,0,0,1,4,0,0,1,1,0,0,1,11,0,0,0,18,1,1,0,0,3,2,0,3,3,0,0,0,1,0,0,1,0,0,0,2,0,1,10,4,1,0,0,0,0,0,1,0,2,32,13,0,0,2,1,0,0,0,0,0,0,0,0,0,1,0,1,0,0,1,0,0,2,0,0,0,2,1,0,1,0,2,0,1,0,15,0,2,2,12,1,0,0,1,6,0,0,1,0,0,1,0,8,2,1,0,1,0,23,0,3,0,2,0,0,1,1,103,0,0,0,0,0,5,23,0,17,0,0,14,2,1,0,0,0,1,0,0,0,0,0,0,0,1,0,3,2,1,0,0,0,0,8,0,1,1,0,0,0,16,0,0,0,0,0,1,0,0,0,0,0,0,0,0,1,0,1,1,2,1,0,1,2,0,2,0,0,0,0,0,6,0,0,1,1,0,0,10,1,3,0,1,0,1,3,1,151,0,0,36,4,0,0,0,3,0,1,0,0,1,0,0,2,1,0,0,0,0,0,0,0,0,0,53,2,0,0,0,1,0,4,0,0,0,0,0,0,2,0,0,0,0,0,1,0,11,0,2,1,1,0,0,0,1,0,0,0,3,1,0,2,0,0,4,0,0,1,0,1,4,21,0,0,2,0,5,0,0,0,0,0,0,0,1,2,1,0,0,0,0,0,0,1,1,0,0,0,2,0,0,0,0,8,2,0,0,0,0,7,0,2,2,0,0,0,0,1,0,13,0,1,0,0,0,0,2,4,0,0,22,0,1,1,2,0,0,1,0,0,1,1,0,0,0,18,0,0,0,0,0,1,0,0,0,0,0,26,0,0,0,0,0,1,0,1,16,5,4,5,0,0,1,0,0,0,1,0,0,0,0,0,2,0,0,0,0,0,1,0,0,0,0,1,0,1,3,1,0,1,0,0,0,1,0,4,1,0,1,0,0,0,1,0,1,1,0,0,0,0,0,1,0,0,0,0,0,0,0,0,0,0,0,0,1,0,0,0,0,0,0,1,2,2,0,1,0,0,6,2,4,0,1,0,0,0,0,0,0,1,0,1,1,0,0,3,1,1,3,0,1,0,0,7,0,0,0,0,0,3,0,0,7,0,0,0,0,0,6,0,0,0,0,2,0,0,0,0,1,0,7,0,0,0,0,3,1,5,0,2,0,0,6,0,3,0,0,1,0,1,0,0,0,0,0,1,1,0,0,4,3,0,0,0,0,1,0,0,0,0,1,1,4,3,1,0,1,37,2,0,0,0,0,0,2,37,0,0,2,0,0,1,0,0,0,0,0,1,0,0,0,1,0,0,1,0,1,0,0,0,0,1,0,0,0,0,0,0,0,0,0,0,0,0,0,0,0,0,0,4,0,0,0,0,0,0,28,0,1,0,3,0,1,0,1,53,0,0,0,0,0,0,0,1,0,0,1,0,0,1,0,3,2,0,0,0,0,1,3,0,0,3,0,0,2,0,0,18,0,0,0,0,0,0,0,0,1,0,0,1,0,3,2,0,2,0,1,92,2,0,0,0,0,6,0,0,1,0,1,0,0,0,0,0,0,0,0,4,0,0,0,11,1,2,0,0,0,0,0,0,1,0,0,5,1,0,0,0,0,0,0,0,0,3,1,3,6,0,0,0,1,0,0,0,0,0,0,0,0,1,0,0,0,0,1,0,0,0,0,2,0,0,0,4,0,0,0,0,9,3,0,0,0,0,0,0,0,2,0,0,2,10,0,1,0,0,0,0,1,0,1,1,0,0,6,0,0,0,11,0,0,7,0,0,0,0,1,0,0,0,0,0,3,0,0,1,0,0,0,0,0,0,0,0,1,0,0,0,0,0,1,0,0,0,0,1,0,0,0,2,0,0,0,0,0,0,0,9,0,1,9,0,0,0,0,0,0,0,0,0,1,0,0,2,0,0,0,0,0,0,4,0,5,0,0,0,0,2,0,0,0,0,0,0,2,1,2,1,0,2,0,0,0,0,0,1,0,0,0,1,0,0,0,0,0,0,0,7,2,0,1,0,0,0,13,0,0,0,1,0,0,0,0,2,0,0,0,0,0,0,0,0,1,0,0,4,0,0,0,0,0,0,0,0,0,0,0,0,197,4,0,1,0,0,0,12,0,0,0,0,0,2,0,0,1,0,0,0,0,0,1,0,0,0,0,2,0,0,1,0,0,0,2,0,0,0,0,0,1,0,0,0,0,0,0,0,0,0,0,0,0,1,0,0,0,4,0,0,0,0,0,0,0,0,0,0,0,15,0,0,0,13,0,0,3,0,0,4,0,1,0,0,1,2,1,0,0,3,1,0,0,0,0,3,0,0,0,0,0,0,1,0,0,0,0,0,0,0,0,0,0,0,0,0,1,0,1,1,0,0,1,0,0,0,0,0,0,0,0,0,0,0,0,0,0,0,0,0,0,0,0,0,0,1,3,1,0,0,0,2,0,0,0,0,0,0,1,1,2,1,1,0,0,0,6,0,0,1,0,0,1,0,0,1,0,0,0,0,0,0,0,0,0,1,0,0,0,0,0,0,0,0,0,0,0,1,0,0,0,0,0,0,0,0,0,0,0,0,0,1,0,0,0,0,0,0,0,0,1,0,1,0,0,0,0,0,0,0,0,0,0,0,0,0,0,0,38,0,0,0,0,0,0,0,0,1,1,7,0,0,0,0,0,1,0,0,0,0,0,0,0,0,0,0,0,0,0,0,0,0,0,0,0,0,0,0,0,0,0,0,0,0,0,0,0,0,0,2,0,0,0,0,1,0,0,1,0,2,0,0,84,0,0,0,0,0,0,0,0,0,0,0,0,0,0,0,0,0,0,2,0,0,0,0,0,0,0,0,0,0,0,0,0,0,0,0,0,0,0,0,0,0,0,0,0,1,0,1,1,0,0,0,0,0,0,0,0,0,0,0,0,0,0,0,0,0,0,0,0,0,0,0,0,0,0,0,0,0,0,0,0,0,0,0,0,0,0,1,0,0,0,1,0,0,0,0,1,0,0,0,0,0,0,0,0,0,0,0,0,0,0,0,0,0,0,0,1,0,0,0,0,0,0,0,0,0,0,0,0,0,0,0,0,0,0,0,0,0,0,0,0,0,0,0,0,1,0,0,0,0,0,0,0,0,0,0,0,0,0,0,0,0,0,0,0,0,0,0,0,0,0,0,0,0,0,0,0,1,0,0,0,0,0,0,0,0,0,0,0,0,0,0,0,0,0,0,0,0,0
"Lung Squamous Cell Carcinoma",593,71,177,2522,103,351,211,43,48,638,77,464,63,138,47,100,998,27,679,57,112,91,4507,18,12,40,117,69,161,58,237,362,47,18,34,72,67,63,65,13,1603,793,116,18,37,204,39,15,95,77,11,16,8,269,47,45,17,33,482,122,914,62,26,23,1412,29,450,54,23,20,13,24,23,122,104,28,4,254,16,236,113,16800,580,93,333,2,216,27,4,70,60,364,275,0,188,17,38,3,6,55,18,144,98,1,7,5,46,46,39,2179,17,24,13,10,31,13,21,12,17,18,439,5,11,16791,287,41,1054,26,260,34,21,309,149,380,66,131,100,10,86,13,9,50,25,20,154,35,3,41,2,15,424,27,341,35,77,11,11172,13496,64,15,5,21,6,5,3,10,641,15,72,31,369,10,174,14,25,21,9,34,119,15,4,441,694,5,11,28,3,2,9,54,326,14,19,76,5,34,333,6,40,163,2,0,3,2,2,19,118,894,1,16246,7,22,305,46,23,93,34,7,33,23,33,8,7,50,18,26,327,260,24,10,43,181,8,0,2,32,8,1109,3,2,22,0,64,18,17,102,5,5,47,12,25,37,5,8,25,147,1,47,8,30,35,3,19,22,44,0,338,129,135,3,57,52,4,4,1,2,7,3,0,2554,83,9,5,14,11,4,56,11,1,2,6,2,153,10,1,18,8,1,46,110,2,7,11,52,2,52,10,0,27,8,13,7,147,6,48,18,137,9,353,0,5,6,14,13,7,43,2,1,1,1,15,172,42,4,4,4,9,1,0,41,135,39,9,5,42,9,2,18,4,0,8,4,1,1,5,16,5,24,4,4,3,2,17,1,36,460,2,16,0,0,4,4764,6,4,12,16,1,3,39,2,131,10,7,26,3,0,5,20,0,10,8,39,0,2,9,16,4,1,8,7,59,5,3,2,68,1,11,8,84,7,0,1,20,584,6,2,8,1,18,3,15,67,175,9,3,1,3,1,6,19,1,23,2,1,9,16,2,6,3,8,7,1,14,59,0,5,0,6,0,1,6,29,114,12,3,0,0,0,3,2,14,5,1,1,3,75,85,1,2,13,21,27,3,9,10,46,2,3,7,1,1,26,5,95,2,0,8,5,28,0,56,3,4,6,135,1,1,35,2,3,7,1,133,1,5,8,7,1,30,10,2,23,9,16,0,5,24,21,1,24,0,6,18,8,0,122,3,128,1,15,1,9,272,1763,5,2,11,5,5,111,249,6,30,0,40,15,13,6,18,6,2,0,3,2,89,7,5,6,10,8,17,5,0,11,1,9,13,2,3,70,10,1,185,13,0,3,4,0,1,1,0,1,7,28,7,0,4,0,0,1,3,6,4,6,3,0,8,7,129,144,2,0,71,11,1,0,4,4,6,5,14,8,0,8,8,77,3,10,1,5,23,7,20,93,1,6,2,7,1,1,268,1,723,5,1,8,2,14,5,26,31,5,7,13,383,9,7,0,3,4,0,1,2,3,0,7,8,0,4,1,2,36,5,1,7,2,2,6,19,28,3,3,5,5,75,0,1,0,7,2,16,6,10,46,82,6,1,109,8,3,202,17,30,0,3,1,5,2,5,8,9,5,3,0,2,0,13,1,1,2,2,2,11,0,0,84,18,1,0,6,1,33,1,0,11,4,3,0,1,1,23,5,11,1,54,6,2,0,0,82,0,9,4,44,2,1,14,0,1,0,9,3,428,1,0,12,0,1,1,3,2,25,3,13,8,8,14,22,0,51,2,1,0,1,70,1,0,3,113,3,1,57,15,0,1,8,1,1,57,17,2,5,41,5,2,0,1,0,7,4,23,13,0,0,3,5,3,7,0,6,1,0,12,1,3,2,4,59,3,5,1,6,2,110,0,12,0,2,0,2,0,3,1,2,21,132,1,268,0,0,14,0,1,30,0,7,5,1,0,0,0,26,1,1,6,9,1,64,2,0,1,15,22,117,16,3,0,5,5,8,0,5,0,2,1,8,25,1,1,12,0,1,11,2,1,0,2,0,0,5,59,1,7,12,4,1,15,23,7,27,0,12,4,0,1,2,13,13,46,1,1,4,2,0,29,10,12,0,30,10,0,1,82,0,8,2,12,0,135,25,3,14,6,1,5,0,2,0,1,5,0,60,10,27,0,4,1,0,46,1,2,0,7,1,1,1,7,0,2,10,59,0,8,2,197,0,11,0,10,8,0,14,7,0,0,0,6,15,8,1,3,0,0,4,0,11,12,0,5,0,8,8,3,3,3,5,2,0,4,2,32,1,22,2,0,4,22,1,0,0,18,11,1,11,0,4,4,4,0,0,3,4,0,1,0,2,22,11,0,0,2,1,5,80,5,3,10,48,0,1,0,0,0,0,74,7,2,1,2,0,1,0,2,2,3,0,9,3,30,3,0,0,44,3,0,0,0,0,6,8,0,4,7,0,5,0,23,9,19,1,78,4,2,37,0,0,1,0,5,0,0,16,34,0,5,1,3,2,7,1,0,3,0,0,0,1,127,0,1,1,1,0,0,14,4,1,11,8,2,1,0,12,146,53,1,1,6,0,0,3,0,41,0,11,1,1,0,0,1,0,0,13,5,0,0,0,0,0,19,57,1,473,130,11,11,0,1,22,1,6,0,5,3,0,0,1,1,1,5,0,0,0,3,3,1,0,6,1,0,8,1,0,28,12,13,0,4,19,4,0,0,1,208,3,3,0,0,10,2,0,1,1,2,25,4,1,0,2,1,0,1,1,6,0,0,1,0,7,67,8,2,0,131,1,0,237,27,8,0,2,20,4,20,13,12,4,5,3,3,0,0,0,5,12,7,3,0,0,3,0,3,4,0,42,42,14,0,5,0,15,0,0,52,0,0,9,0,19,6,3,4,3,0,1,0,0,1,0,5,4,0,3,0,2,0,17,0,364,2,0,54,1,2,3,16,0,0,1,2,1,0,142,1,2,1,1,0,0,0,10,33,0,1,0,5,0,0,0,0,0,0,0,2,0,2,4,0,14,1,2,46,23,8,2,2,3,0,0,8,1,3,8,4,3,2,2,0,8,0,0,65,0,0,0,0,4,6,0,0,0,8,0,15,1,1,1,1,2,10,0,0,43,0,0,1,4,1,20,0,1,0,1,4,7,4,4,2,19,5,2,0,7,8,2,44,1,0,1,17,2,1,0,1,0,0,1,0,1,2,7,17,1,0,1,0,0,0,1,0,3,0,8,0,19,18,6,1,2,1,2,4,1,1,0,0,0,29,0,1,0,5,5,0,0,0,10,7,2,0,1,0,0,0,1,4,3,0,4,0,0,0,0,0,4,9,1,6,8,0,157,3,2,0,19,2,1,0,8,0,0,1,7,2,3,6,0,19,0,3,6,2,2,6,36,0,0,9,0,0,1,1,3,4,0,1,0,0,1,2,1,0,0,1,0,0,68,1,2,0,0,1,8,2,31,1,0,22,0,3,1,0,0,1,5,0,2,2,1,0,2,5,0,0,0,3,18,0,1,1,154,0,2,0,5,10,2,0,1,0,0,1,0,0,0,4,1,0,0,19,0,5,0,40,0,0,0,0,3,0,2,1,0,25,3,5,6,0,0,0,5,0,0,144,0,1,0,10,1,0,14,0,3,1,0,21,0,7,2,0,11,1,10,4,2,0,17,0,0,3,1,0,0,0,4,0,6,6,1,31,0,0,200,0,11,0,1,2,1,1,3,0,0,0,0,1,0,1,1,0,8,52,3,3,0,1,7,2,0,1,8,0,0,4,0,15,0,2,1,0,0,24,1,1,1,0,0,64,1,0,0,0,0,0,1,9,0,0,1,2,0,1,0,1,0,0,78,1,0,1,4,0,5,1,1,4,19,1,0,0,0,0,0,8,5,0,0,2,0,2,1,1,1,10,0,3,1,1,0,2,2,0,1,79,2,1,1,7,0,16,0,0,3,0,1,30,5,0,4,36,1,4,42,0,43,0,1,4,0,0,0,0,0,6,0,13,0,0,0,1,3,0,3,0,1,0,0,0,0,0,46,0,0,0,1,1,0,1,0,0,3,1,1,0,0,1,0,0,0,2,6,3,1,0,0,0,0,1,3,0,0,1,2,0,0,5,0,1,0,0,1,2,0,0,0,0,1,1,1,1,0,0,0,1,0,1,1,0,0,0,4,0,0,0,0,0,6,0,0,0,6,0,19,1,0,0,0,1,0,745,112,10,3,5,1,2,1,0,8,0,0,3,4,191,55,1,0,1,13,0,3,0,0,5,0,5,0,1,1,3,7,0,1,1,1,0,0,0,1,0,0,0,0,0,0,0,5,0,0,3,1,2,22,1,1,2,24,33,2,4,0,22,0,7,0,1,0,2,1,1,0,2,6,1,0,0,1,0,1,2,9,0,0,1,2,0,0,0,1,0,5,0,0,11,0,0,0,1,0,3,1,1,0,0,3,2,0,1,0,0,3,0,0,1,0,18,0,0,2,0,8,0,0,0,1,1,0,7,0,11,1,2,1,0,1,0,1,1,0,0,1,0,0,4,1,2,0,0,0,2,0,0,4,3,0,0,1,2,9,0,0,1,2,0,1,0,0,3,0,0,0,0,1,8,1,7,1,2,0,0,0,187,0,0,0,1,0,0,0,0,0,0,0,0,9,3,0,0,0,0,0,1,0,6,1,1,0,0,0,0,0,0,0,0,26,1,4,0,0,0,0,1,0,1,0,1,17,0,0,0,0,1,0,0,0,1,12,19,0,0,0,0,0,52,0,0,0,0,1,0,1,0,1,0,1,2,5,0,0,1,3,0,0,1,0,0,0,0,2,4,0,0,3,1,2,1,15,1,0,0,2,0,0,0,0,1,1,0,1,2,1,5,0,1,1,1,1,0,0,3,0,0,0,3,4,2,0,0,12,0,0,40,0,3,0,2,4,1,0,0,0,0,2,3,0,0,0,0,0,3,0,1,0,571,0,0,101,8,0,0,1,2,0,0,3,4,0,3,0,0,0,0,25,2,6,0,0,1,0,1,0,0,0,2,0,0,0,3,1,0,0,1,1,0,1,0,0,0,0,2,0,0,7,1,0,1,0,2,0,1,0,0,0,0,2,6,0,0,7,0,1,0,0,0,1,1,2,0,0,0,1,0,0,1,0,6,0,0,13,0,0,1,1,1,1,1,0,0,1,0,3,0,1,2,1,4,0,0,1,1,1,0,4,2,0,2,0,0,0,0,6,2,0,10,0,0,0,6,1,1,25,1,0,0,0,1,3,0,5,1,1,0,1,0,0,15,1,33,2,0,2,0,19,0,0,0,2,0,0,2,0,0,0,0,0,0,6,0,2,0,0,0,0,0,0,0,8,1,3,0,64,0,0,0,2,6,0,0,0,0,0,1,0,3,12,1,0,1,3,0,0,0,0,0,0,0,0,0,0,14,1,0,0,0,0,0,2,0,0,2,0,0,0,1,0,0,0,7,3,0,0,0,0,1,0,0,0,0,0,1,2,0,0,1,12,0,0,0,0,1,0,1,0,1,0,1,0,0,0,0,12,1,0,0,0,1,0,0,1,0,12,0,1,14,0,0,1,0,0,4,0,8,0,3,0,4,0,0,0,1,0,0,0,0,7,1,9,0,0,60,1,5,0,0,0,0,0,0,0,2,20,11,0,1,1,0,0,1,0,1,2,1,3,1,3,0,1,0,3,8,0,1,0,0,0,7,0,1,0,1,0,0,7,0,0,0,0,0,3,0,0,0,1,6,0,0,0,1,1,0,1,0,1,0,2,3,0,23,0,0,1,0,0,0,12,0,0,0,1,0,0,1,0,0,0,0,5,0,2,0,4,0,0,0,0,0,0,0,6,0,4,0,0,0,0,0,1,0,0,2,0,0,0,3,1,0,0,0,0,0,0,0,0,0,11,5,0,0,0,0,0,0,1,0,0,0,0,2,0,0,0,0,0,1,1,0,0,3,0,0,0,0,0,0,0,0,0,0,1,0,4,0,2,2,0,0,0,0,1,3,0,0,0,0,0,0,0,5,0,0,0,0,0,3,2,0,0,3,0,0,0,0,18,0,0,0,0,0,1,12,0,7,0,0,4,3,0,0,0,0,0,0,0,0,1,0,0,0,1,0,1,0,0,0,0,0,0,5,0,3,0,1,0,0,9,0,0,2,0,0,3,0,0,1,0,1,0,0,0,1,1,0,0,3,0,1,0,1,0,0,0,0,0,2,0,1,0,1,0,0,0,0,0,0,2,0,0,0,0,1,0,14,2,0,12,1,0,0,0,2,1,0,0,0,0,0,0,0,0,0,0,0,0,0,0,0,0,0,3,0,0,0,0,0,0,1,0,0,0,0,0,0,0,0,0,3,0,0,1,0,6,0,0,0,1,0,0,0,0,1,0,0,0,0,0,0,0,0,2,0,0,0,0,0,5,3,0,0,0,0,12,0,2,0,0,0,0,0,0,0,0,0,0,0,0,0,0,0,1,0,0,1,0,0,0,0,0,5,2,0,0,0,0,9,1,1,0,0,0,3,0,1,0,1,1,0,0,0,0,0,0,0,0,0,18,0,0,1,0,0,0,1,0,0,0,1,0,0,0,5,0,0,0,0,0,0,1,0,0,0,0,19,0,0,0,0,0,1,0,0,7,11,2,0,0,0,1,0,0,0,0,0,0,0,0,1,1,0,0,0,0,0,0,0,1,0,0,0,0,0,0,0,0,0,0,0,0,0,1,1,0,0,1,0,0,0,0,0,0,0,0,0,0,0,0,0,0,0,0,0,0,0,0,0,0,0,0,0,0,0,0,1,1,0,0,0,1,0,0,0,0,0,0,0,3,1,0,0,0,0,0,0,0,0,0,0,0,0,0,2,2,0,1,0,0,0,0,5,0,0,0,0,3,0,0,0,5,0,0,0,0,1,10,1,0,0,0,2,0,0,0,0,0,0,2,0,0,0,0,1,0,2,0,1,0,0,4,0,1,0,0,0,1,0,0,0,0,0,0,0,0,0,0,5,1,0,0,0,1,1,0,1,0,1,0,0,0,2,0,0,0,18,0,1,0,0,0,0,2,12,0,0,1,0,0,0,0,0,0,0,0,0,0,0,0,0,0,0,0,0,0,0,0,0,0,1,0,0,0,0,0,0,0,0,0,0,0,0,0,3,0,0,0,4,0,0,0,0,0,0,7,0,0,0,0,0,0,0,2,55,0,0,0,1,0,0,0,1,0,0,0,0,0,0,1,2,0,0,1,0,0,0,0,0,0,1,0,0,0,0,0,5,0,0,0,0,0,0,0,0,1,0,0,0,0,3,0,0,0,0,1,37,0,0,0,0,0,0,1,0,0,0,0,0,0,0,0,0,0,0,0,4,0,0,0,3,0,0,0,0,0,0,0,0,0,0,1,4,0,0,0,0,0,0,0,0,0,1,0,0,1,1,0,0,0,0,0,0,0,0,0,0,0,1,0,0,0,0,0,0,0,0,0,4,0,0,0,0,0,0,0,0,2,1,0,0,0,0,0,0,0,2,0,6,3,5,0,1,0,1,0,1,0,0,0,0,0,1,0,0,0,0,4,0,0,19,0,0,0,0,0,0,0,0,0,0,0,0,0,0,0,0,0,0,0,0,0,1,1,0,0,0,0,0,1,0,0,0,0,1,0,0,0,1,0,0,0,0,0,0,0,0,0,1,2,0,0,0,0,0,0,0,0,2,1,0,0,2,0,0,0,0,1,0,3,0,2,1,0,0,0,1,1,0,0,0,0,0,0,0,0,2,1,0,2,0,0,0,0,0,0,0,0,0,1,0,0,0,0,0,0,3,0,0,0,0,0,0,3,0,1,0,1,1,0,0,0,0,0,0,1,0,0,0,0,0,0,0,0,1,0,0,0,0,0,0,0,0,0,0,0,0,7,2,0,0,0,0,0,11,0,0,0,0,0,2,0,0,0,0,0,0,0,0,0,0,0,0,0,3,0,0,0,0,0,0,1,0,0,0,0,0,0,0,0,0,0,0,1,0,0,0,0,0,0,1,1,0,0,4,0,0,0,0,0,0,0,0,0,0,0,8,0,0,0,9,0,0,2,0,0,2,0,1,0,0,0,1,1,0,0,0,1,0,0,0,0,1,0,0,0,0,0,0,0,0,0,0,0,0,0,0,0,0,0,0,0,0,0,0,2,1,0,3,0,0,0,0,0,0,0,0,0,0,0,0,1,0,0,0,0,0,0,0,0,0,0,0,1,0,0,0,0,2,0,0,0,0,0,0,0,0,0,0,0,0,0,0,1,0,0,0,0,0,0,0,0,0,0,0,0,0,0,0,0,0,0,1,0,0,0,0,0,0,0,0,0,0,0,0,0,0,0,0,0,0,0,0,0,0,0,0,0,0,0,0,0,0,0,0,0,0,0,0,0,0,0,0,0,0,0,0,0,0,0,0,0,0,1,0,9,0,0,0,0,0,3,0,0,1,0,0,0,0,0,0,0,7,0,0,0,0,0,0,0,0,0,0,0,0,0,0,0,0,0,0,0,0,0,0,0,0,0,0,0,0,0,0,0,0,0,1,0,0,0,0,0,0,0,0,0,1,0,1,2,0,0,0,0,0,0,0,0,0,0,0,0,0,0,0,0,0,0,1,0,0,0,1,0,0,0,0,0,1,0,0,0,0,1,0,0,0,0,0,0,0,0,0,0,0,0,0,1,0,0,0,0,0,0,0,0,1,0,0,0,0,0,0,0,0,0,0,0,2,0,0,0,0,0,0,0,0,0,0,0,0,0,0,0,0,0,0,0,0,0,0,0,0,0,0,0,0,0,0,0,0,0,0,0,0,0,0,0,0,0,1,0,0,0,0,0,0,0,0,0,0,0,0,0,0,0,0,0,0,0,0,0,0,0,0,0,0,0,0,0,0,0,0,0,0,0,0,0,0,0,0,0,0,0,0,0,0,0,0,0,0,0,0,0,0,0,0,0,0,0,0,0,0,0,0,0,0,0,0,0,0,0,0,0,0,0,0,0,0,0,0,0,0,0,0,0,0,0
"Melanoma",4291,492,496,9205,128,1443,1175,220,393,591,719,752,100,208,447,162,5374,218,285,684,972,129,19299,168,105,244,424,411,292,80,660,560,199,217,318,538,184,140,212,51,3848,7033,774,107,466,1086,59,203,1094,622,84,44,103,479,77,388,154,140,1691,620,155786,168,115,113,4747,119,1209,275,48,93,105,138,68,244,1115,144,70,772,50,578,930,3074,865,179,686,45,1642,62,48,186,128,108985,122,52,1750,80,1122,90,53,527,178,150,356,141,214,38,156,304,40,6851,162,39,78,81,47,117,97,146,80,82,56,228,38,2106,43,151,4096,122,110,596,37,541,904,161,530,128,691,55,507,33,87,114,140,63,126,228,27,132,182,49,1872,51,557,177,570,91,1176,1819,198,171,798,183,32,41,498,116,2163,104,45,121,711,9,71,115,29,123,155,241,689,26,162,815,660,27,23,270,60,20,41,87,241,115,35,41,25,238,124,44,72,78,427,2,15,40,16,39,103,2772,318,1506,17,886,1353,331,62,712,137,14,35,42,215,41,5,36,28,36,98,2069,168,110,122,442,72,95,31,499,25,1057,14,9,62,1,95,418,3,431,73,222,733,96,148,29,27,12,212,1206,9,222,118,198,73,26,188,314,189,17,409,619,371,30,600,709,39,59,12,13,55,33,17,1291,1161,35,30,94,53,14,268,16,16,13,19,2,380,21,7,59,55,15,261,28,23,41,42,735,131,761,44,21,120,56,453,173,912,60,1227,66,47,17,355,84,31,21,49,49,34,334,29,6,15,254,23,31,128,30,35,34,9,17,3,1122,180,122,111,20,118,2,110,62,105,35,36,14,18,34,14,12,7,56,26,11,36,44,328,11,10,220,18,76,2,5,8,1433,47,31,45,32,26,218,50,19,243,99,37,27,14,48,65,15,29,14,63,76,12,50,1,24,16,12,70,47,17,51,24,25,231,36,59,101,351,792,60,25,128,4865,14,8,16,8,42,29,48,1428,33,15,59,74,44,18,30,56,3,30,33,77,21,117,11,6,2,75,76,9,6,46,8,29,8,7,4,3,14,114,264,248,11,49,18,12,39,30,44,8,3,39,6,446,310,10,69,29,22,58,40,26,375,346,8,20,11,11,4,280,121,101,22,4,11,28,369,31,279,17,11,49,316,12,22,489,7,114,76,6,324,6,29,9,23,56,227,10,42,206,43,138,7,88,65,223,2,62,7,135,25,26,10,518,9,16,5,4,4,44,380,269,153,35,36,13,55,915,271,48,175,7,178,32,51,20,24,8,1,7,5,4,525,19,21,14,33,350,9075,44,27,17,3,46,18,15,35,18,5,7,90,41,21,12,28,3,24,8,66,2,32,114,17,6,41,9,4,99,65,163,14,148,89,4,84,37,22,27,23,8,1009,3,13,14,32,25,54,3,157,19,3,25,9,21503,32,37,11,67,206,25,49,263,38,34,5,11,52,28,164,7,727,8,11,21,12,47,19,89,69,5,4,33,523,21,18,1,8,17,6,62,6,3,7,14,1,3,16,1,4,42,115,8,35,16,0,7,93,70,117,6,43,12,186,42,10,44,45,18,98,51,55,57,230,37,10,1105,23,10,210,348,1885,6,20,12,24,8,5,291,12,15,21,4,6,1,60,7,1,4,13,6,29,4,18,207,24,2,9,19,11,96,6,3,41,14,24,13,0,8,27,40,29,23,4,13,265,1,3,101,9,18,24,47,4,103,57,17,4,20,42,4,209,4,3,143,5,42,5,32,7,111,12,18,32,29,13,20,7,16,401,19,6,34,69,17,10,13,96,5,7,522,7,5,8,6,3,129,3,205,2,10,427,19,15,7,1,3,11,18,12,10,7,31,16,19,4,16,23,89,5,0,7,8,2,3,1,130,6,44,93,7,70,31,19,286,7,82,0,31,5,9,2,10,25,703,5,47,41,21,306,1,0,194,0,79,7,0,5,4,12,356,3,7,6,23,1,110,3,11,0,80,48,15,92,65,16,913,80,27,10,149,0,4,3,19,154,16,151,12,2,6,131,36,2,17,15,1,0,34,436,14,11,42,40,26,48,65,90,369,3,28,95,1,3,7,11,87,14,2,42,21,5,5,463,21,51,0,92,20,1,15,232,20,61,12,93,4,185,135,47,205,36,7,23,3,21,1,13,24,4,90,32,1029,1,9,58,31,106,11,12,2,153,1,15,1,16,2,10,38,9,4,48,63,223,1,80,4,11,146,54,76,16,24,2,72,143,142,43,4,5,2,2,12,1,36,178,2,5509,1,160,9,4,2,28,12,10,2,18,297,27,2,160,34,2,14,144,7,46,2,71,86,4,12,2,149,35,3,8,1,9,4,3,5,0,2,89,31,5,1,5,12,9,3,2,33,6,52,5,164,0,1,3,9,50,157,3,13,17,9,5,4,10,3,2,0,18,3,193,7,6,8,97,29,3,9,2,12,57,41,2,9,76,7,3,16,1692,2,60,10,10,25,5,145,2,0,1,0,5,1,3,192,87,3,16,45,11,8,9,113,6,12,18,2,2,20,9,0,3,3,14,16,2,21,26,3,49,8,8,8,3,28,37,7,193,1,9,5,6,0,20,69,3,103,7,2,6,2,3,3,1,62,87,7,6,17,1,12,111,8,1,114,2,938,12,1,1,28,1,8,0,45,0,9,3,1,10,52,9,2,0,2,24,33,1,1,11,29,11,3,3,7,373,21,5,8,19,0,26,0,3,55,242,2,11,1,0,29,5,4,2,29,7,8,22,6,5,5,1,5,5,3,7,1,2,12,0,61,3,44,10,12,21,1,8,140,236,23,3,3,11,84,86,14,188,97,66,17,5,6,24,0,46,31,459,123,18,2,12,0,2,83,1,8,200,3,15,12,13,23,4,4,17,0,3,22,3,43,15,20,3,3,1,2,12,6,6,0,20,22,0,0,5,2,4,3,0,195,18,9,48,4,4,1,272,2,3,1,2,2,3,171,2,8,0,52,3,2,3,55,34,4,24,5,69,8,2,0,1,1,2,5,7,38,5,55,1,38,12,105,11,59,6,5,6,13,2,2,29,6,20,24,27,58,87,12,0,15,12,2,9,0,1,2,3,44,12,5,11,3,3,3,108,13,4,12,6,12,64,1,22,134,1,1,0,63,116,73,23,5,3,3,17,20,12,21,1,34,34,3,0,5,318,3,371,58,0,77,93,3,2,3,5,1,2,4,4,8,5,98,7,8,7,24,2,1,8,0,18,19,4,51,1,9,268,7,7,12,13,7,8,1,1,2,2,1,50,2,241,1,1,11,2,6,3,5,17,3,18,7,31,5,2,24,73,24,16,9,2,2,14,2,1,1,16,15,22,69,2,453,3,4,2,78,0,10,3,36,0,48,12,7,34,11,0,3,26,1,10,8,34,109,27,44,0,10,2,1,6,10,1,49,12,0,3,6,13,252,64,0,2,1,4,2,1,93,2,0,3,10,1,51,0,46,21,1,32,5,52,4,9,2,6,0,2,0,38,0,5,5,9,0,3,4,2,6,1,2,7,54,9,0,3,20,8,19,5,62,2,11,78,2,2,1,7,0,1,0,53,1,22,5,169,2,1,21,65,26,0,1,4,0,230,8,51,15,4,2,6,94,3,1,1,5,4,10,2,3,1,21,0,10,4,5,14,6,22,3,0,149,65,66,6,10,2,62,10,5,13,1,0,0,0,30,0,35,14,3,1,0,35,790,11,2,13,27,73,11,4,0,1,0,1,2,0,3,2,8,2,41,8,23,0,0,1,94,32,6,1,42,8,0,5,1,57,1,22,1671,0,14,223,10,10,6,1,5,267,5,1,8,0,4,0,3,30,0,8,13,2,23,9,0,15,3,2,10,6,9,5,55,7,8,3,2,6,13,1,0,9,0,4,2,40,1,0,69,3,32,38,5,1,2,13,18,2,8,2,0,0,64,1,1,52,8,6,8,9,1,705,0,2,55,0,1,9,25,1,2,58,63,6,95,2,208,4,4,1,1,2,0,3,15,933,3,31,0,1,2,2,1,50,3,2,0,22,1,0,0,2,652,0,1,1,1,29,0,20,1,0,4,2,5,0,2,246,6,2,3,2,25,8,7,9,0,8,0,6,16,1,5,20,53,1,1,7,1,2,8,6,1,3,19,5,2,1,3,31,10,1,0,1,1,23,0,0,7,21,2,4,19,5,0,1,7,0,95,2,3,4,22,0,7,6,67,0,1,2,4,39,83,34,15,1,10,5,1,0,34,3,0,2,9,29,17,5,4,30,4,3,11,0,0,391,1,71,0,4,2,31,17,3,1,0,4,0,1,0,4,2,0,0,0,0,5,0,13,0,7,8,5,6,395,47,0,2,54,5,1,32,0,26,5,158,2,7,0,5,32,1,0,0,23,8,1,16,7,12,16,0,24,1,0,1,17,1,1,0,2,0,70,3,4,5,19,1,2,5,0,2,3,3,0,0,8,0,21,2,0,1,5,0,0,6,0,97,1,1,1,24,13,1,2,0,1,0,0,16,1,6,6,1,2,4,8,2,2,10,3,0,13,3,1,0,4,2,0,7,9,2,0,1,14,26,10,1,0,5,34,0,4,7,35,19,0,0,8,8,0,1,9,5,4,2,5,10,0,1,3,11,0,128,1,0,49,0,1,1,0,2,1,2,3,1,88,0,0,0,2,0,0,10,0,55,11,0,2,9,6,1,1,3,12,1,50,11,6,0,0,0,13,4,0,0,0,1,7,5,6,1,8,5,1,3,2,2,70,22,0,2,2,0,4,36,3,2,0,4,9,4,0,0,0,1,22,59,13,0,3,8,12,0,2,3,2,4,0,0,2,72,0,43,62,1,26,2,12,2,23,1,16,3,1,1,0,2,12,5,1,3,18,18,0,34,7,1,0,6,1,1,7,9,12,8,0,20,3,1,61,0,0,423,0,1,1,16,4,1,0,7,22,6,16,19,1,4,5,3,0,5,1,2,43,12,3,0,27,1,0,0,2,15,1,0,16,5,4,80,0,1,4,16,19,24,55,1,4,2,3,2,5,0,4,20,2,0,1,2,4,19,2,2,0,0,5,2,0,9,3,4,56,2,12,1,0,10,0,0,12,0,0,0,1,1,12,5,0,5,13,1,3,4,8,2,0,3,0,0,2,24,42,0,5,5,1,2,1,7,278,5,2,3,0,0,1,5,62,1,1,0,0,1,3,200,28,23,13,7,13,0,1,0,1,11,2,24,2,0,0,0,18,2,0,1,2,1,1,35,9,25,7,1,2,0,2,2,3,0,116,5,0,0,5,0,4,5,0,436,0,0,15,0,73,2,2,0,81,1,6,26,0,1,0,0,2,7,11,0,8,38,0,2,1,4,0,1,0,15,6,4,54,1,216,9,2,3,1,13,0,0,0,2,0,12,19,2,12,2,4,0,0,0,1,2,0,8,1,0,2,1,17,0,11,4,3,1,0,30,4,1,2,0,1,3,4,0,0,209,52,1,3,0,9,0,11,1,0,12,3,2151,3,14,3,22,29,11,0,9,27,28,0,6,4,0,1,0,0,0,3,2,6,3,12,0,280,0,0,0,2,0,10,2,3,1,82,6,3,2,11,9,0,27,12,9,0,79,0,2,0,24,0,1,20,6,2,14,14,4,0,7,27,2,0,4,2,0,0,2,1,8,18,25,2,0,2,0,2,5,7,3,25,9,2,6,2,1,755,1,0,2,2,7,4,0,1,12,0,7,2,2,1,2,415,1,3,0,0,6,31,2,0,1,5,19,0,0,0,1,0,5,0,0,3,6,2,94,4,153,10,14,7,2,2,0,12,0,0,2,14,0,13,133,0,0,2,22,22,4,1,5,19,8,1,3,2,1,6,1,0,20,1,1,0,1,0,1,0,0,1,0,1,1,6,4,3,0,0,0,0,24,0,0,0,46,43,7,11,0,17,0,0,1,0,0,1,1,0,29,1,2,1,0,4,0,1,0,0,2,0,0,0,1,8,0,1,1,2,1,1,0,70,0,4,1,64,23,10,0,16,25,1,0,3,2,0,4,2,24,1,3,15,15,0,73,0,2,9,2,5,8,0,0,16,3,4,0,0,18,4,28,1,223,0,0,0,30,2,2,1,0,2,1,1,0,5,1,6,1,8,4,3,3,1,0,0,0,5,5,1,8,1,4,0,0,34,0,0,12,1,0,2,0,1,4,2,1,0,0,0,0,6,2,4,6,1,2,0,0,0,9,2,0,0,36,3,49,1,3,4,0,1,10,0,15,0,0,40,1,4,8,10,90,33,2,12,1,0,0,4,26,3,9,0,3,13,0,2,3,5,1,0,0,0,0,10,5,1,0,0,2,0,1,0,0,6,0,0,40,0,1,0,0,0,4,1,1,0,1,2,0,5,0,2,1060,21,1,1,0,1,0,0,4,1,2,0,2,0,1,12,3,0,2,0,0,2,58,2,1,1,0,1,0,5,10,0,0,0,5,0,0,14,2,0,0,0,10,5,1,833,0,0,0,0,1,6,2,1,3,39,1,0,1,0,26,26,3,18,0,2,1,0,3,0,1,0,1,0,0,39,1,4,52,3,0,8,1,0,1,1,0,0,6,0,0,2,2,5,1,2,3,2,0,2,0,0,1,3,7,0,0,1,8,1,0,0,0,1,13,0,8,12,1,10,0,0,0,2,0,2,0,0,1,49,0,0,1,1,0,2,0,0,0,0,1,8,0,1,1,0,0,1,0,0,1,0,1,0,0,1,5,0,2,0,2,0,1,9,0,5,1,11,0,2,2,0,0,8,1,2,0,2,5,1,1,0,1,0,0,11,5,1,0,0,0,0,3,4,2,1,0,0,1,3,60,96,2,2,0,24,1,0,0,0,1,1,0,1,3,0,1,12,702,0,0,2,0,0,22,0,1,0,1,20,1,0,0,14,7,1,0,0,4,6,1,0,0,0,0,0,0,11,0,15,0,54,0,1,0,0,56,1,4,0,6,2,0,0,1,14,0,1,2,0,4,0,0,0,0,4,2,1,9,0,1,5,0,0,1,2,10,0,0,1,32,1,0,16,4,0,1,8,0,5,0,0,0,0,69,2,79,0,1,2,9,0,3,1,1,0,1,0,1,0,0,0,4,0,0,12,0,4,1,0,0,7,0,0,1,6,0,1,1,0,0,0,0,0,0,0,3,5,3,0,1,0,0,0,4,1,0,10,1,0,0,0,0,1,0,3,5,2,0,0,3,3,1,4,0,2,0,1,0,0,0,826,2,0,0,4,2,4,1,0,0,0,1,1,0,2,0,0,56,0,0,0,3,0,1,0,2,2,0,1,1,0,28,0,0,0,3,23,3,5,0,0,0,2,16,0,0,0,0,1,0,12,1,1,0,0,0,0,11,1,0,1,14,0,1,0,0,5,1,0,0,0,0,4,11,0,0,0,0,1,2,0,0,1,1,0,0,8,5,0,0,0,0,3,0,5,0,0,1,5,0,0,4,0,0,0,0,1,3,0,11,0,1,0,7,0,0,0,0,5,2,0,4,0,1,2,4,2,0,0,1,19,3,1,4,0,0,0,1,0,0,3,1,0,1,75,2,6,2,4,3,1,68,0,0,0,0,8,0,0,1,0,0,10,1,0,12,2,0,0,0,0,0,0,1,0,3,0,0,0,1,6,0,0,0,5,10,1,3,0,1,1,0,2,0,0,1,0,3,2,3,3,0,2,0,0,9,1,0,0,19,275,0,5,1,0,1,0,8,1,137,33,8,11,38,0,0,0,23,0,0,0,0,0,1,0,0,7,44,1,3,13,1,0,0,21,0,1,5,18,0,3,0,0,0,1,0,0,0,4,0,1,1,0,1,11,0,0,0,0,0,2,0,0,3,1,1,0,3,0,0,0,0,2,0,0,9,0,0,0,1,1,0,1,0,3,0,0,0,0,2,0,5,0,1,0,2,1,0,1,2,0,1,1,0,2,0,2,0,0,8,1,0,1,0,0,18,0,0,0,0,0,0,1,0,1,0,1,0,0,1,0,0,8,1,12,1,0,1,0,0,1,18,0,0,1,11,7,0,0,0,0,0,1,4,5,2,0,2,0,0,1,7,0,0,30,0,0,0,0,0,0,0,1,0,5,0,3,3,0,0,0,0,2,2,1,0,1,0,0,1,20,0,1,0,0,0,0,2,0,0,1,2,0,0,0,2,25,1,0,2,1,0,3,52,3,0,0,0,0,0,18,0,1,0,0,0,0,0,0,3,3,0,0,3,1,25,1,0,10,0,0,0,0,0,0,0,0,0,1,0,11,2,0,0,31,0,0,2,0,0,0,0,0,2,0,2,2,0,0,0,0,0,141,0,0,14,0,0,0,7,0,1,0,6,0,3,0,0,0,0,0,1,0,0,0,0,4,0,0,0,0,0,0,0,1,0,0,1,2,0,1,0,1,0,0,0,0,0,0,0,0,0,0,0,0,6,0,1,0,19,0,0,0,1,0,2,1,2,1,0,0,0,1,11,0,5,0,0,0,0,0,1,7,1,0,0,0,0,0,0,1,0,0,0,0,0,0,0,0,0,0,0,1,0,2,8,0,0,0,1,0,1,1,0,0,0,0,13,0,5,0,0,0,0,0,0,0,1,0,0,0,0,0,0,1,0,0,0,0,0,0,0,1,0,0,0,1,0,0,0,0,1,1,0,1,0,0,0,0,0,1,2,1,0,0,0,0,0,2,0,0,5,0,0,5,0,0,1,0,0,0,0,0,3,0,0,0,0,0,2,0,0,0,0,0,13,0,2,0,0,0,0,8,0,0,0,0,0,0,1,0,21,0,0,0,1,9,0,0,0,0,0,0,0,0,0,0,1,0,0,0,0,0,0,0,0,0,0,0,0,1,0,4,0,0,0,0,1,0,0,1,0,0,0,0,0,0,0,0,0,0,0,0,0,0,0,0,0,0,0,0,0,0,0,0,0,0,0,1,0,0,1,0,0,0,0,0,0,0,0,0,0,0,0,0,1,0,0,0,0,0,0,0,0,0,0,0,0,0,0,0,0,0,0,0,0,0,0,0
"Mesothelioma",331,32,67,913,56,132,91,23,17,159,44,545,36,54,41,130,574,7,341,37,46,35,813,7,3,37,64,28,74,70,169,128,112,3,21,30,41,72,37,6,605,892,75,6,50,64,33,3,62,16,0,11,4,176,18,24,8,10,168,264,523,32,8,9,389,53,116,10,6,15,42,3,16,12,29,23,2,135,13,81,81,720,15675,72,272,1,138,10,2,23,25,179,68,5,96,15,35,13,3,30,4,64,280,1,8,4,53,13,37,230,11,38,3,3,88,9,12,6,5,7,131,3,2,644,64,27,227,12,367,18,8,122,95,1442,43,36,38,4,36,9,3,24,20,13,81,17,1,42,1,9,184,14,108,32,33,11,561,514,31,3,1,16,6,6,0,6,117,4,23,29,158,6,34,22,11,10,21,17,28,13,1,249,198,3,2,20,12,1,10,19,418,4,33,42,3,7,162,3,5,12,1,0,2,3,2,8,58,251,1,884,3,2,192,34,13,76,12,12,18,6,44,14,1,17,42,2,307,79,13,5,25,80,10,0,5,3,93,64,1,1,6,0,20,40,4,53,1,1,21,4,7,6,1,4,31,79,1,24,15,20,76,3,5,450,20,2,85,87,89,4,11,26,2,3,1,0,6,0,1,53,49,5,9,0,1,8,37,2,0,1,3,0,34,7,1,85,0,30,23,27,2,4,10,93,0,94,6,2,8,3,2,6,111,10,343,6,6,2,161,0,2,2,1,2,6,38,3,0,0,0,5,47,25,5,0,4,15,1,0,33,52,14,10,52,14,4,1,6,5,1,8,0,0,0,0,1,5,24,0,3,4,1,29,0,4,1916,3,13,1,0,0,206,1,2,1,3,0,0,22,0,31,9,1,3,1,3,5,6,1,2,4,22,0,6,2,2,2,1,58,6,12,3,1,0,20,0,3,10,56,0,13,0,4,36,3,1,0,0,54,0,9,3,173,4,1,1,0,0,0,3,1,3,4,0,3,1,1,0,2,6,0,1,2,26,0,3,1,2,1,0,4,7,18,23,0,1,0,3,35,2,9,5,3,0,3,51,36,0,1,2,9,10,0,2,52,12,3,20,3,1,0,9,0,34,2,0,0,2,50,0,90,2,3,0,60,3,2,4,3,6,2,0,33,0,1,1,3,0,42,4,1,49,1,13,1,3,4,12,0,4,0,3,21,3,0,55,4,29,1,3,0,2,37,31,0,1,6,1,4,33,48,4,31,2,29,8,6,6,1,1,6,3,2,0,18,6,9,2,7,51,12,2,0,19,4,7,2,0,2,2,8,1,10,6,0,3,21,0,3,0,3,2,2,10,1,0,4,1,0,1,2,1,9,4,1,0,2,4,1369,11,1,1,45,12,0,2,4,0,9,1,11,2,0,1,0,38,2,2,1,2,137,1,25,11,1,0,0,10,0,17,126,1,71,4,0,1,0,2,0,9,26,2,3,5,20528,14,1,0,1,8,0,2,1,0,2,9,2,0,0,1,0,2,1,0,5,42,0,0,10,7,2,0,3,2,61,1,0,0,4,1,2,2,9,23,29,0,2,122,0,2,10,42,3,1,6,1,4,1,2,6,7,19,3,0,4,0,5,2,1,5,2,0,1,1,1,23,5,0,0,2,0,6,2,0,10,0,2,0,0,0,110,0,21,0,11,2,21,1,0,8,0,5,1,13,7,0,5,1,4,0,8,1,64,1,1,75,0,5,3,2,2,10,0,7,2,13,2,0,0,14,0,0,1,1,240,2,17,0,103,1,1,106,1,0,0,1,3,0,11,47,3,31,46,3,1,0,0,0,6,5,5,1,1,1,0,0,2,0,0,7,4,0,1,1,2,0,1,20,0,2,0,3,1,21,0,4,0,1,0,4,0,0,0,0,1,32,2,31,1,1,1,0,0,99,0,0,2,1,0,0,1,2,2,0,1,6,0,97,0,0,3,8,4,151,14,1,0,0,3,1,1,21,0,1,0,2,15,2,0,1,0,1,6,2,1,0,2,0,0,1,94,2,2,4,3,4,1,15,5,22,4,1,3,0,0,0,4,5,8,0,3,5,1,7,2,0,7,0,21,2,0,0,21,0,0,1,6,0,139,43,0,5,3,0,6,0,0,0,0,2,0,19,9,12,0,1,2,1,16,0,3,0,5,0,0,0,2,0,0,3,7,1,3,2,11732,0,5,0,1,0,0,0,1,0,0,1,6,12,14,0,3,0,0,1,0,17,0,0,4,0,0,1,0,0,1,1,0,0,1,0,85,1,15,3,1,7,4,2,0,0,5,23,0,9,0,6,0,1,6,2,6,0,0,0,0,0,5,0,0,2,0,5,0,10,1,3,5,9,0,0,0,0,0,1,15,10,0,0,2,0,2,0,0,1,0,0,3,36,31,0,0,0,11,0,0,0,1,1,3,0,0,0,56,0,0,0,1,3,3,0,26,2,0,14,0,0,0,0,0,0,0,31,7,0,3,18,2,0,3,4,8,2,1,0,0,1,44,0,2,1,0,2,0,1,3,0,2,3,4,0,0,4,23,1,0,0,0,0,0,1,1,104,0,1,1,0,0,1,2,0,0,3,5,1,3,0,0,1,13,76,2,47,19,1,2,0,0,44,0,1,0,2,3,0,0,1,0,3,0,0,0,0,0,19,0,0,1,2,0,9,0,0,54,2,5,0,1,5,34,1,0,2,8,0,2,0,0,9,0,0,0,0,0,13,2,1,0,0,0,0,0,0,2,1,0,1,0,5,0,0,0,0,14,0,2,1541,80,3,1,2,5,0,5,4,1,0,5,3,1,2,0,0,2,41,3,1,1,0,1,0,0,0,0,244,67,3,0,2,1,9,0,0,4,0,1,7,0,13,2,4,0,2,2,0,0,0,1,2,5,3,0,0,0,0,1,5,0,74,2,0,27,0,2,1,9,0,0,0,0,0,1,46,0,0,0,1,2,0,0,2,5,0,0,0,6,1,0,0,0,0,0,0,1,1,0,79,0,9,2,14,257,0,1,1,1,12,0,0,3,0,3,1,0,5,0,6,0,4,0,0,142,0,4,0,2,0,2,0,0,0,4,0,42,0,1,3,1,1,7,0,0,22,0,0,0,0,0,11,0,0,0,0,0,3,1,1,1,18,0,0,0,0,191,0,3,5,0,0,29,0,0,0,2,0,0,0,0,0,0,0,8,0,0,1,1,0,0,1,1,24,0,5,0,3,29,0,1,0,0,3,4,0,2,0,0,0,16,0,0,0,0,1,0,0,1,6,7,0,0,0,0,0,0,1,15,2,0,2,0,0,0,0,1,0,6,0,4,13,0,56,1,0,0,29,1,0,1,2,0,1,0,31,2,1,0,0,2,1,1,0,0,4,5,0,0,0,2,0,0,0,2,0,3,0,0,0,0,1,0,2,0,0,0,0,1,11,0,0,0,0,0,0,1,86,0,0,0,0,5,1,0,7,0,3,0,0,2,0,1,0,3,0,0,0,0,1,0,1,0,23,0,0,0,4,5,3,5,2,0,0,0,2,5,0,3,0,0,0,3,2,6,0,19,1,0,1,0,0,0,1,3,0,104,0,5,5,0,0,1,5,0,0,22,0,0,0,6,0,0,0,0,9,0,0,5,0,0,0,0,8,1,3,2,0,1,3,0,0,8,0,0,0,0,6,0,2,13,0,0,1,0,13,2,4,0,3,5,0,0,0,0,0,1,0,0,2,1,0,0,4,1533,6,1,0,1,7,2,15,0,2,0,0,6,4,53,0,2,1,0,0,35,0,0,0,0,4,135,0,0,2,0,0,0,1,2,0,0,0,0,0,0,0,1,0,4,20,1,0,0,0,0,1,0,0,0,0,0,0,1,0,0,0,7,9,0,0,5,1,1,0,0,1,4,0,0,2,0,0,1,0,0,1,24,0,2,0,1,0,0,0,0,1,0,0,34,6,0,0,25,2,3,27,1,55,0,0,0,0,0,1,2,1,1,0,9,0,0,1,1,52,1,0,0,0,1,1,0,0,1,5,1,0,0,1,0,0,1,0,0,0,0,0,0,0,2,0,0,0,0,5,0,1,2,0,0,0,1,0,0,0,1,1,0,0,1,0,0,0,0,0,0,0,0,0,1,0,1,0,0,0,0,0,0,0,2,1,0,1,0,0,0,0,0,0,0,41,0,2,0,16,0,1,0,0,0,0,0,0,13,4,3,1,1,5,2,0,0,20,0,0,0,3,53,5,1,0,1,0,0,0,0,0,1,0,1,0,0,0,4,7,0,0,0,1,0,0,1,0,0,0,0,0,0,1,0,16,0,0,1,1,1,9,0,0,0,4,1,0,0,2,2,0,1,0,1,0,1,0,1,0,1,1,5,0,1,0,0,2,0,4,11,0,0,0,0,0,0,5,0,0,0,0,24,0,3,0,1,0,1,0,1,0,0,0,0,0,0,0,0,0,0,0,0,0,21,0,0,0,0,8,0,0,0,0,0,0,3,0,6,0,0,0,0,0,0,0,0,3,0,0,0,0,0,0,3,1,0,0,1,0,0,0,9,0,0,0,0,0,0,0,2,10,0,0,0,0,0,0,0,0,0,0,1,0,0,0,0,1,0,0,14,0,0,1,0,1,0,1,0,2,0,2,0,21,0,0,1,0,0,0,1,0,14,1,0,0,1,0,0,0,1,50,0,41,0,0,0,0,0,0,0,0,0,0,0,2,0,14,0,0,2,0,0,0,0,8,3,0,0,2,0,0,12,0,0,0,1,0,0,0,1,0,0,0,0,3,0,0,0,1,0,0,9,0,2,0,0,0,1,0,0,0,1,0,1,6,4,1,1,3,0,0,0,0,0,2,0,0,0,1,0,0,0,1,4,0,0,0,0,0,0,0,1,0,1,0,0,3,0,0,0,0,0,0,12,1,0,0,0,1,0,0,0,0,1,0,0,1,3,1,58,0,48,1,0,10,0,0,0,0,1,0,0,2,7,0,1,0,0,1,0,0,2,2,0,0,0,0,0,0,0,0,0,0,0,2,0,1,0,0,0,0,0,1,0,0,0,0,2,0,0,1,0,0,0,0,1,0,0,0,0,1,0,0,0,0,0,0,4,0,2,2,0,0,1,0,1,0,5,0,0,0,1,0,0,0,0,2,0,0,0,0,3,0,1,0,1,0,0,0,0,101,5,0,0,0,0,0,0,0,0,0,0,0,0,0,0,0,0,7,1,0,20,0,0,0,5,1,0,7,0,0,0,0,6,0,0,0,0,0,0,0,0,0,2,0,25,0,0,0,0,1,1,0,0,0,0,0,0,0,0,1,0,0,0,4,0,1,3,0,0,0,0,0,0,2,0,9,0,3,0,0,0,0,0,0,0,0,0,0,0,0,8,3,0,0,0,1,0,0,0,0,0,1,0,0,0,0,2,0,0,0,0,1,1,1,0,0,12,1,0,0,0,1,0,0,1,8,0,0,0,0,0,0,0,0,0,0,3,0,0,0,46,16,0,2,1,0,2,0,0,0,26,0,1,0,0,0,0,5,0,0,0,0,1,0,0,0,0,1,0,0,2,0,0,0,0,0,1,0,4,2,1,0,2,0,0,0,1,0,0,0,0,1,0,37,0,0,14,1,0,0,0,1,0,0,0,0,0,58,1,0,0,1,0,0,0,1,1,3,0,0,0,0,0,0,2,0,2,0,1,7,1,1,0,0,140,0,0,0,0,1,0,0,0,0,1,4,0,0,1,1,1,0,0,0,0,1,2,0,0,0,0,0,1,1,2,1,0,0,0,0,0,4,0,0,1,1,1,0,0,2,0,0,0,5,0,0,0,37,0,0,0,0,1,0,0,0,2,0,0,0,0,0,0,1,0,0,1,0,0,0,18,0,0,0,0,0,1,0,0,0,5,0,3,29,0,0,0,0,0,0,0,0,0,0,0,0,0,0,0,0,0,0,0,0,0,0,0,0,0,0,0,0,0,0,0,0,0,5,1,0,0,4,0,2,0,0,0,0,0,0,0,0,0,0,5,1,9,0,1,0,3,0,0,0,0,0,0,0,0,7,0,0,0,0,1,2,3,0,4,0,0,1,0,1,0,0,0,0,0,0,0,0,0,0,0,1,0,1,0,0,0,0,0,0,1,0,0,0,0,0,0,2,0,0,0,0,0,0,0,0,0,0,0,0,0,0,2,0,0,0,0,0,0,0,0,0,0,0,0,0,1,0,7,0,0,0,0,0,0,1,0,0,0,0,0,0,0,0,0,0,0,3,0,0,0,0,0,17,0,0,0,1,0,0,0,1,0,0,0,0,0,0,0,0,0,3,1,0,0,0,0,0,0,0,0,0,0,0,0,0,0,0,0,0,0,0,0,0,0,1,0,0,0,0,0,0,0,0,1,0,0,0,0,0,0,2,0,0,0,0,0,0,2,0,0,0,0,2,0,0,0,0,0,0,0,0,0,2,0,0,0,0,0,0,0,2,0,0,0,0,0,0,0,0,26,1,0,0,0,0,7,2,0,4,0,0,0,0,0,0,2,0,0,0,0,0,0,0,2,0,0,0,0,0,0,0,0,0,0,0,0,0,0,0,1,0,203,0,0,0,0,0,2,0,0,0,0,0,4,0,0,0,0,0,0,0,0,3,3,2,0,0,0,0,0,0,0,0,0,0,0,0,0,0,0,0,0,0,0,0,0,0,0,0,0,0,1,0,1,0,0,0,0,0,1,0,1,0,0,0,0,0,0,1,0,0,0,0,0,0,0,0,0,0,0,3,0,0,0,0,0,0,0,0,0,0,5,0,0,0,0,0,0,0,0,0,0,0,0,1,0,0,0,0,0,0,0,0,0,0,0,0,0,1,0,0,0,0,2,1,0,0,0,0,0,1,0,0,0,0,0,0,0,4,0,0,2,0,0,8,0,0,0,1,9,0,0,0,0,0,0,7,0,0,0,0,0,0,1,0,0,0,0,2,0,0,0,0,0,0,1,0,0,0,0,0,0,0,0,0,2,2,0,0,0,0,1,0,0,0,0,0,1,4,0,0,0,1,5,0,1,0,0,0,0,0,0,0,0,0,0,0,0,0,0,0,0,0,0,0,0,0,0,0,0,0,0,0,0,0,0,0,0,0,0,0,0,0,0,0,0,0,0,0,0,0,1,2,0,0,0,0,0,0,2,2,0,4,0,0,0,0,0,2,0,3,5,0,0,0,0,0,0,0,0,0,0,0,0,0,0,0,8,0,0,0,0,0,0,2,0,0,0,0,0,0,0,5,6,0,0,0,0,0,0,0,0,1,0,0,0,0,25,0,0,0,0,0,4,3,0,0,0,0,2,0,0,0,0,0,0,0,0,0,0,0,0,0,0,0,0,0,1,1,0,0,0,0,0,0,0,0,0,0,1,0,0,0,0,0,0,0,0,0,0,0,0,1,0,0,0,0,0,0,0,0,0,0,0,0,0,0,1,0,0,0,0,0,0,0,1,0,0,0,0,0,0,0,0,1,3,0,0,0,0,0,0,0,0,0,0,6,129,1,0,0,0,0,0,0,0,1,0,0,0,2,0,0,0,1,0,0,0,0,0,0,0,0,0,0,0,0,0,1,0,0,0,0,0,0,0,0,0,0,0,0,0,0,1,0,0,1,0,0,0,1,0,0,0,0,0,5,0,0,0,0,3,0,0,0,0,0,0,0,0,0,1,0,0,0,0,0,0,0,0,0,0,0,0,0,0,1,0,5,0,0,0,0,2,0,0,0,0,0,0,0,0,0,0,0,0,0,0,0,1,0,0,0,0,0,0,0,0,0,0,0,0,0,21,0,0,0,0,0,0,1,0,0,0,0,0,0,0,0,0,0,0,0,0,0,0,0,0,0,0,0,0,0,0,0,0,0,0,1,0,0,0,0,0,1,2,0,0,0,0,0,2,0,0,0,0,0,0,0,0,0,0,0,0,0,0,0,0,0,0,0,3,0,0,0,0,0,0,2,0,1,0,0,0,0,4,0,0,1,0,0,0,0,0,0,0,0,12,0,0,1,0,0,1,0,0,0,0,0,0,0,0,0,3,0,0,0,478,0,0,2,0,0,0,0,0,0,0,0,0,0,0,0,0,0,0,0,0,0,4,0,0,0,0,0,0,0,0,0,0,0,0,0,0,0,0,0,1,0,0,0,0,0,0,0,0,0,0,0,2,0,0,0,0,0,0,0,0,0,0,0,0,0,0,0,0,0,0,0,1,1,1,0,0,0,0,0,0,0,0,0,0,0,0,2,0,0,0,0,0,0,0,0,0,0,0,0,0,0,0,0,0,0,0,0,0,0,0,0,0,3,0,0,0,0,0,0,0,0,0,0,0,0,0,0,0,0,0,0,0,0,0,0,0,0,0,1,0,0,0,0,0,0,0,1,0,0,0,3,0,0,0,0,0,0,0,0,0,0,0,0,0,7,0,0,0,0,0,0,0,0,0,0,5,0,0,0,0,0,0,0,0,0,0,0,3,0,0,0,0,0,0,0,0,0,0,0,0,0,0,0,0,0,0,0,0,0,0,0,0,0,0,0,0,0,0,0,0,0,0,0,0,0,4,0,0,0,0,0,0,0,0,0,0,0,0,0,0,0,0,0,0,0,1,0,1,0,0,0,0,0,0,0,0,0,0,0,0,0,0,0,0,0,0,0,0,3,0,0,0,0,0,0,0,0,0,0,0,0,0,0,0,0,2,0,0,0,0,0,0,0,0,0,0,0,0,0,0,0,0,0,0,0,0,0,0,0,0,0,0,0,0,0,0,0,0,0,0,0,0,0,0,0,0,0,1,0,0,0,0,0,0,0,0,0,0,0,0,0,0,0,0,0,0,0,0,0,0,0,0,0,0,0,0,0,0,0,0,0,0,0,0,0,0,0,0,0,0,0,0,0,0,0,0,0,0,0,0,0,0,0,0,0,0,0,0,0,0,0,0,0,0,0,0,0,0,0,0,0,0,0,0,0,0,1,0,0,0,0,0,0,0,0,0,0,0,0,0,0,0,0,0,0,0,0
"Ocular melanomas",114,35,63,432,2,181,29,3,5,5,9,27,3,12,12,3,118,3,15,8,15,2,445,2,1,3,6,2,5,2,12,14,7,49,4,6,3,0,3,0,56,81,101,1,16,15,0,49,9,12,4,2,3,12,2,4,0,2,55,59,4314,16,0,1,184,5,29,52,2,0,1,2,2,18,15,14,0,19,5,14,6,32,45,14,34,1,25,1,0,15,5,3055,7,0,32,0,14,0,0,8,1,1,21,0,10,1,9,11,3,67,1,0,2,5,2,7,0,1,1,3,2,2,0,20,0,3,81,0,5,9,2,7,20,2,6,2,7,2,4,0,1,3,1,7,4,3,0,5,2,1,39,1,12,0,5,2,11,13,13,0,288,1,2,0,187,1,82,1,1,0,12,0,0,1,1,1,8,10,19,0,0,27,13,0,0,12,0,0,0,2,4,1,1,1,2,6,3,1,0,2,142,0,1,0,0,2,1,31,102,18,4,7,47,4,3,6,5,0,0,2,4,0,0,0,1,1,5,73,0,1,29,38,1,20,0,1,0,23,0,1,0,0,2,12,0,29,0,76,8,5,8,0,0,2,7,8,1,15,0,9,7,0,2,3,1,0,4,4,15,0,12,13,1,0,0,0,0,0,2,11,8,1,1,5,8,0,5,1,2,0,0,0,3,0,1,1,1,0,5,0,0,1,1,107,57,116,2,5,12,13,167,3,4,4,87,5,0,0,9,0,1,5,1,1,2,1,1,1,2,106,1,0,11,0,0,0,0,0,0,1,2,0,0,0,5,0,1,3,2,12,2,0,0,0,1,1,0,6,4,0,1,1,1,0,0,3,0,1,0,0,0,27,0,4,1,0,0,3,0,0,20,1,1,6,1,1,0,1,0,0,0,2,0,1,0,0,0,0,0,0,0,1,1,0,4,0,2,1,6,234,0,0,2,72,0,0,1,0,2,4,0,9,1,0,1,1,0,0,0,6,0,2,1,1,1,1,0,0,0,0,0,2,0,0,0,1,0,0,1,0,1,3,2,4,2,17,0,0,0,0,2,0,2,0,0,100,6,0,26,5,0,0,0,2,8,5,0,0,1,1,2,4,0,1,0,0,0,0,21,3,4,1,0,14,6,0,0,5,1,0,1,0,5,0,0,0,1,22,1,1,16,13,0,2,1,19,1,10,1,1,1,56,0,0,0,16,0,0,0,1,0,0,29,1,0,5,0,0,1,234,2,1,1,0,2,0,5,2,0,0,0,0,0,0,8,2,0,0,1,6,384,0,1,0,0,8,1,0,1,0,0,0,2,0,1,0,0,0,1,0,1,0,2,1,0,0,0,0,0,32,0,53,2,2,2,0,0,0,1,1,4,0,5,1,0,1,3,1,0,0,1,2,0,2,1,202,2,0,0,0,2,0,0,1,0,3,0,0,17,0,6,0,21,0,0,0,1,0,1,11,7,0,0,0,16,0,0,0,1,0,0,0,1,0,1,0,0,0,0,0,0,0,54,1,0,0,0,1,0,1,5,0,12,1,15,1,0,0,1,0,1,2,0,0,23,2,0,3,1,0,4,16,113,0,1,1,0,0,1,0,0,0,0,0,0,0,0,0,0,0,0,0,0,0,0,2,0,0,0,0,0,0,0,0,0,0,5,2,0,0,0,0,1,1,0,0,1,0,0,24,0,0,0,0,0,0,0,0,0,1,0,0,8,0,0,1,0,0,0,0,0,0,1,0,0,1,1,0,0,0,121,1,0,1,0,1,0,0,3,1,0,19,0,0,0,0,0,58,0,15,0,0,8,7,2,0,0,0,1,0,0,0,0,2,2,2,0,2,0,10,0,0,0,0,0,0,0,1,0,1,0,0,1,0,0,1,0,0,0,0,2,1,0,2,0,17,0,0,17,0,4,0,0,6,0,0,0,0,0,0,0,1,0,0,0,0,0,0,0,0,0,3,0,0,2,0,0,35,1,3,0,11,0,0,0,1,4,0,53,1,0,0,2,0,0,0,0,0,0,10,7,0,0,0,6,0,1,0,6,3,0,2,3,0,0,1,0,16,0,0,1,1,1,0,0,0,1,0,0,0,0,1,2,0,0,0,3,0,3,0,8,0,3,0,1,0,1,0,0,1,0,0,2,21,0,0,2,10,4,0,1,0,2,0,0,1,0,0,0,0,0,0,0,0,9,0,3,0,0,1,18,0,4,2,0,30,6,5,1,1,0,0,0,3,0,2,78,0,205,0,2,0,0,1,0,2,0,0,1,82,1,0,7,2,0,1,0,0,0,1,2,24,0,0,0,4,0,0,0,1,0,0,0,0,0,0,0,1,0,1,0,0,0,0,0,0,2,1,0,55,0,0,0,1,3,4,0,2,2,0,0,0,0,0,0,0,0,0,6,0,0,0,3,0,0,0,0,5,0,1,1,0,3,0,0,0,193,0,1,2,0,0,2,1,0,0,0,0,0,0,0,1,2,0,0,4,1,0,0,2,0,0,0,0,0,0,0,0,0,1,7,0,0,2,1,0,1,0,0,1,0,2,2,0,72,0,0,0,0,0,0,1,0,1,0,0,0,0,0,0,0,2,10,5,0,0,0,0,1,0,0,2,0,21,0,0,0,0,0,0,0,0,0,0,0,0,0,8,0,0,0,1,2,6,1,0,3,0,1,0,0,3,4,1,0,0,2,0,1,0,0,3,7,0,0,0,0,0,1,0,0,0,0,0,1,0,1,0,0,0,2,0,0,0,0,0,0,0,0,0,0,0,0,0,0,1,2,0,0,1,0,1,0,0,1,32,2,0,0,0,0,0,0,0,1,3,0,0,0,0,0,1,0,0,2,0,0,0,0,1,0,1,0,0,0,0,1,0,0,0,0,0,0,0,0,0,1,0,1,9,0,0,0,0,0,1,0,5,0,0,1,0,0,0,1,0,0,0,1,0,0,0,0,0,0,13,0,0,0,2,1,0,5,0,17,0,0,0,0,0,0,0,0,16,0,6,0,1,0,2,1,2,2,0,1,0,0,0,0,0,1,4,0,0,1,0,0,0,0,1,0,0,0,0,0,1,0,2,0,0,0,0,11,1,0,1,1,0,1,0,9,1,0,0,0,0,9,1,9,0,0,0,8,1,1,1,0,0,1,0,0,1,12,0,24,1,0,0,1,0,0,0,0,1,0,0,0,0,0,1,0,0,0,0,0,0,0,0,0,1,0,1,0,0,3,0,0,1,0,0,0,0,0,0,0,0,1,0,84,0,0,0,0,0,2,0,0,0,1,0,9,0,0,0,5,0,1,0,0,1,4,0,0,0,0,0,0,2,1,2,0,0,0,0,0,0,0,0,0,0,0,0,4,0,0,0,0,0,0,0,0,1,0,10,0,0,0,0,0,2,0,0,0,0,0,0,0,32,17,0,0,0,0,0,0,0,0,0,0,0,0,1,0,0,7,0,0,0,1,0,0,0,2,0,0,0,0,0,0,0,0,0,0,0,0,0,0,0,0,0,0,0,0,0,0,0,0,0,0,2,0,0,0,0,1,0,0,0,1,0,0,1,2,0,0,7,27,0,0,0,0,0,0,0,0,0,0,0,0,0,0,0,0,0,0,0,0,1,0,1,0,0,0,0,1,0,1,0,0,2,0,1,0,1,0,2,0,3,0,0,0,0,0,1,0,0,0,1,0,0,0,2,0,0,1,0,1,3,0,0,0,0,0,0,0,0,1,2,1,0,0,0,0,0,0,8,10,0,0,0,0,0,0,0,1,0,2,15,0,0,2,0,2,0,0,0,15,1,0,0,0,0,0,0,0,0,0,0,0,1,4,0,1,0,0,0,0,0,0,3,4,0,0,0,0,1,0,0,0,0,0,0,1,0,0,0,2,7,13,0,1,0,0,5,0,0,0,0,0,17,0,1,1,4,0,0,0,0,7,0,0,0,0,1,0,4,0,1,0,0,0,1,0,22,0,0,0,0,0,0,0,0,8,1,0,0,1,0,0,0,0,0,0,0,1,0,0,0,0,5,0,0,0,0,0,0,1,0,0,0,0,0,0,0,0,1,0,0,0,0,0,0,0,0,0,0,0,0,0,0,6,0,1,0,0,0,0,3,1,0,0,0,0,0,0,0,15,0,0,0,0,0,0,0,0,0,0,0,0,0,0,0,0,1,0,1,0,0,0,0,0,0,0,31,0,0,0,1,0,2,0,0,0,0,0,0,0,0,0,0,0,2,1,9,0,0,0,0,0,2,0,0,0,0,0,0,0,0,3,0,0,0,0,0,0,0,0,0,0,0,0,0,0,0,0,0,0,1,2,0,1,6,11,0,0,0,0,0,0,0,0,1,0,0,0,0,0,1,0,0,0,0,1,0,0,1,0,0,0,1,0,0,0,0,0,0,0,0,0,0,0,0,0,10,0,0,0,0,0,0,1,0,0,0,0,0,0,0,0,0,0,0,0,0,0,0,0,0,7,0,0,0,0,0,0,0,1,0,0,0,0,0,0,2,0,0,0,0,0,1,0,0,0,0,0,0,0,0,0,0,0,0,0,5,0,0,0,0,0,2,0,0,1,0,0,0,0,0,0,0,0,0,0,0,0,0,0,0,3,0,1,0,0,0,0,0,0,0,1,0,0,0,0,1,0,0,0,0,0,0,0,0,1,0,0,0,0,0,0,0,0,1,0,0,0,0,0,0,0,2,0,0,0,0,0,0,1,0,0,3,0,0,0,0,0,0,1,0,0,0,0,0,0,0,0,0,0,0,0,0,0,0,0,0,26,0,0,0,1,0,1,0,0,0,0,0,0,0,0,0,22,0,0,0,0,0,0,0,0,2,0,0,0,0,1,1,0,0,0,0,0,0,20,0,0,0,0,1,0,0,0,1,1,0,0,0,0,0,0,0,1,0,0,0,0,1,0,0,0,0,1,7,1,0,0,4,0,0,0,0,0,2,0,0,0,0,0,0,0,0,0,0,0,0,0,0,0,0,0,0,16,0,6,0,0,0,0,0,0,0,0,0,0,0,0,1,0,0,2,0,0,0,0,0,0,0,3,1,0,20,0,0,0,0,0,0,0,0,0,0,0,1,0,0,0,0,0,0,0,1,0,2,0,0,0,0,0,0,0,11,0,0,0,0,0,0,0,2,0,0,0,0,0,0,0,25,0,0,0,0,0,0,1,0,0,0,0,1,0,0,0,0,0,0,0,0,0,0,0,0,0,0,0,0,1,1,0,1,1,0,0,0,0,0,0,0,0,3,0,0,0,0,0,0,0,0,6,0,0,15,0,0,0,0,0,2,0,0,0,0,0,0,0,0,1,1,0,1,1,0,1,0,0,0,0,0,0,0,0,2,0,90,1,0,0,0,7,0,0,0,0,0,0,0,0,3,0,0,0,0,0,0,0,0,0,0,0,0,0,0,0,0,0,0,0,0,2,0,0,0,0,0,0,0,0,0,0,0,1,0,0,0,0,0,1,0,2,0,98,0,0,1,3,0,0,0,3,10,0,0,0,0,0,0,0,0,0,1,0,0,0,0,0,70,0,0,0,0,0,0,0,1,0,0,0,1,0,0,0,0,1,0,0,0,0,0,0,0,2,0,0,5,0,0,0,0,0,0,0,0,0,0,0,1,0,0,0,0,3,0,0,1,0,0,0,0,0,1,0,2,0,0,0,0,0,32,0,0,0,0,0,0,0,1,0,0,0,0,0,1,0,0,0,0,0,0,4,0,0,0,0,0,0,0,0,0,0,0,0,0,0,0,2,0,2,0,9,0,4,2,0,0,0,0,0,0,1,1,0,2,21,0,0,0,8,1,0,0,0,0,3,0,0,0,0,2,0,0,5,0,0,0,0,0,1,0,0,0,0,0,0,0,0,0,0,0,0,0,0,0,0,0,0,0,0,2,0,0,0,0,0,0,0,0,0,0,0,0,0,0,0,0,0,0,0,0,0,0,0,0,0,1,0,0,0,0,0,0,0,2,0,1,0,0,10,0,0,0,0,0,0,0,0,0,0,0,0,0,0,4,0,0,2,0,0,0,0,0,2,0,0,0,0,0,0,0,0,1,1,0,3,0,0,0,0,0,0,0,0,0,0,0,0,0,0,0,0,0,0,0,0,0,0,0,0,0,0,0,0,0,0,0,0,0,0,0,0,0,0,0,0,0,1,0,0,0,0,0,0,0,0,3,0,0,0,0,0,0,0,0,0,0,0,3,2,0,0,0,0,0,10,0,0,0,0,10,0,2,0,4,1,0,0,0,0,0,0,3,1,0,0,0,0,1,0,0,0,0,0,0,0,0,0,0,0,0,0,0,0,0,0,0,0,0,0,0,5,0,0,0,0,0,0,0,0,0,1,0,0,0,0,0,23,0,0,0,0,0,0,0,0,0,0,0,0,0,0,0,0,0,0,0,0,0,0,1,0,1,0,0,0,0,0,0,0,0,0,0,0,1,0,0,0,0,1,1,0,16,0,0,0,0,1,0,0,0,0,1,0,0,0,0,0,8,0,0,0,0,0,0,0,0,0,0,0,0,0,3,1,0,1,0,0,2,0,0,0,0,0,0,0,0,0,0,0,5,0,0,0,0,0,0,0,0,0,0,0,0,0,0,0,0,0,0,0,0,0,0,1,0,0,0,0,0,0,1,0,0,0,0,0,0,0,0,0,0,0,0,0,0,0,0,0,1,0,1,0,0,0,0,0,0,0,0,0,0,0,1,0,0,0,0,0,0,0,0,0,0,0,2,0,1,0,0,0,0,0,0,0,1,0,0,0,0,0,0,0,0,0,0,0,0,0,0,1,0,0,0,0,0,0,0,24,0,2,0,0,5,0,0,0,0,0,0,0,0,0,0,0,0,6,0,0,0,0,0,0,0,0,0,1,0,0,0,0,0,0,0,0,0,0,0,0,0,0,0,0,0,0,0,0,0,0,0,0,0,0,0,0,0,0,0,0,0,0,0,1,0,0,0,1,0,0,0,0,0,0,0,0,0,0,0,0,0,0,0,1,0,0,0,0,0,32,0,0,0,0,0,0,0,0,0,0,0,0,0,0,0,13,0,0,0,0,0,0,0,0,0,0,0,0,0,0,0,0,0,0,0,0,0,0,0,0,2,0,0,0,1,0,0,0,0,0,0,0,0,0,0,1,0,0,0,0,0,0,0,0,0,0,3,0,0,0,0,0,0,0,0,0,0,0,0,0,0,0,0,0,0,0,0,0,0,0,7,0,0,0,0,0,0,0,0,0,0,0,0,0,0,0,0,0,0,0,0,3,0,1,0,0,0,0,0,0,0,0,0,0,0,2,5,0,0,0,0,0,0,2,0,0,0,0,0,0,0,1,0,0,0,0,0,0,0,0,0,4,0,0,0,0,1,0,0,0,0,0,0,0,0,0,0,0,0,0,0,0,0,0,0,0,0,0,0,0,0,0,0,0,0,0,0,0,1,0,0,0,0,0,0,0,0,0,0,0,0,0,0,0,0,0,0,0,0,0,0,0,0,0,0,0,0,0,0,0,0,0,0,0,0,0,0,0,0,0,0,0,0,0,2,0,0,0,0,1,0,2,0,0,0,0,1,0,0,0,0,0,4,0,0,6,0,0,0,0,0,0,0,0,0,0,0,0,0,0,0,0,0,0,0,0,0,0,0,0,0,0,0,0,0,0,0,0,0,0,1,0,0,0,0,0,0,0,0,0,2,0,3,0,0,0,0,0,0,39,1,2,0,0,0,0,0,0,0,0,0,0,0,0,0,0,3,0,0,0,0,0,0,0,7,0,0,0,4,0,0,0,0,0,0,0,0,0,0,0,0,0,0,0,3,0,0,0,0,0,0,0,0,0,0,0,0,0,0,0,0,0,0,0,0,1,0,0,0,0,0,0,0,0,0,0,0,0,0,0,0,0,0,0,0,0,0,0,0,0,0,0,0,0,0,0,0,0,0,6,0,0,0,0,0,0,0,0,0,0,0,0,0,0,0,0,0,0,0,0,0,0,1,0,0,0,0,0,0,0,0,0,0,0,0,0,0,0,0,0,0,0,0,0,0,0,0,0,0,0,0,0,0,0,0,0,0,0,0,0,0,0,0,0,0,0,0,0,0,0,0,0,0,0,1,0,0,0,0,0,5,0,1,0,0,0,0,0,0,0,0,2,0,0,0,0,0,0,0,0,0,0,0,1,0,0,0,0,0,0,6,0,0,0,0,0,0,0,0,0,0,0,0,0,0,0,1,0,1,0,0,0,0,0,0,0,0,0,0,0,0,0,0,0,0,0,0,0,0,0,0,0,0,0,0,0,0,0,0,0,0,0,9,0,0,0,0,0,0,0,0,0,0,0,0,0,0,0,0,0,0,0,0,0,0,0,1,0,0,0,0,0,0,0,0,0,0,0,0,0,0,0,1,0,0,0,0,0,0,0,0,0,0,0,0,0,0,0,0,1,0,0,0,0,0,0,0,0,0,0,0,0,0,0,0,3,0,0,0,0,0,0,5,0,0,0,0,0,0,0,0,0,0,0,0,0,0,0,0,0,0,0,0,0,0,0,0,0,0,0,0,0,0,0,0,0,0,0,0,3,0,0,0,0,0,0,0,0,0,0,0,0,0,0,0,0,0,0,0,0,0,0,0,0,0,0,0,0,0,0,0,0,0,0,0,0,0,0,0,0,0,0,0,0,0,0,0,0,0,0,0,0,0,0,0,0,0,0,0,0,0,0,0,1,0,0,0,0,0,0,0,0,0,0,0,0,0,0,0,0,0,0,2,0,0,0,0,0,0,0,0,0,0,0,0,0,6,0,0,0,0,0,0,0,0,0,0,0,0,0,0,0,0,0,0,0,0,0,0,0,0,0,0,0,0,0,0,0,0,0,0,0,0,0,0,0,0,0,0,0,0,0,0,0,0,0,0,0,0,0,0,0,0,0,0,0,0,0,0,0,0,0,0,0,0,0,0,0,0,0,0,0,0,0,0,0,0,0,0,0,0,0,0,0,0,0,0,0,0,0,0,0,0,0,0,0,0,0,0
"Ovarian Cancer",1898,557,833,11713,196,1333,594,300,1154,252,276,670,197,291,182,255,2921,719,414,210,588,166,8280,609,117,73,664,287,683,48,623,1525,106,17,111,153,195,94,258,52,4636,3346,372,183,257,792,39,10,913,97,70,266,85,602,46,159,50,146,4215,6155,2958,774,91,316,6087,236,994,310,54,46,184,145,75,47,137,159,58,884,77,562,679,3013,4212,434,1803,132,982,69,42,121,38,1137,312,57,769,29,132,2990,26,223,60,373,2003,18,91,144,347,197,14,2492,42,18,432,293,206,72,227,40,84,78,61,34,32,1245,44,400,3162,31,95,94,24,1133,701,102,277,372,152,148,450,61,27,485,53,97,237,119,44,116,16,104,1742,48,1097,136,466,81,595,1005,160,50,10,92,27,22,20,21,1509,49,69,94,1303,19,49,151,31,316,97,114,90,39,18,1951,1794,21,20,115,2800,33,31,107,276,26,36,66,19,437,57,17,79,261,6,4,42,29,124,86,280,1031,13,1349,10,37,1261,190,23,454,90,14,57,49,534,27,12,42,28,56,58,1151,91,41,76,578,49,2,397,14,51,1374,23,22,31,2,506,146,3,100,84,34,142,160,55,10,38,14,174,575,25,165,58,368,207,4,140,4837,404,76,847,555,451,30,94,248,57,110,11,1,26,11,85,258,477,35,22,65,22,5,174,8,83,35,9,1,622,57,38,523,10,13,196,11,205,40,51,204,6,209,81,4,102,68,7,8,464,153,803,84,7,8,2005,5,32,9,43,19,16,165,51,32,75,19,32,34,73,18,11,10,4,14,2,351,200,33,98,129,61,10,39,28,24,4,20,3,4,23,9,12,22,28,12,13,10,13,113,46,25,961,3,321,2,1,3,1130,8,154,14,3,25,10,41,24,36,27,27,43,29,22,102,184,96,23,47,220,2,14,6,48,17,13,3979,16,107,30,63,8,147,4,23,6499,257,11,43,18,13,369,18,17,11,49,1083,10,87,33,61,33,5,13,3,22,8,12,2,31,81,16,8,12,17,19,6,33,33,1,5,20,5,30,836,21,8,47,20,87,517,174,2,5,1,9,5199,101,247,3,0,10,4,223,858,9,7,16,17,95,3,15,63,70,21,190,6,27,3,42,3,370,5,4,11,512,89,1,5440,7,63,6,168,2,15,136,16,31,37,3,429,5,5,10,5,2,104,10,5,1795,65,7,4,32,34,29,22,34,19,15,47,29,12,2308,8,13,2,2,5,25,217,160,7,57,103,4,20,327,397,24,74,2,102,14,95,20,126,5,3,7,5,1,189,40,40,21,9,61,127,16,11,35,6,98,20,1,7,10,18,8,284,26,1,9,696,0,11,25,54,3,50,82,20,175,36,3,2,10,36,3,41,57,12,1,39,17,24,10,6,783,259,20,5,5,22,4,48,4,37,17,1,17,8,339,20,11,7,29,806,18,338,386,11,31,3,551,1,26,1342,2,363,13,23,15,10,19,137,19,144,0,19,105,924,145,24,0,31,469,19,12,24,6,3,133,9,17,3,1,11,219,3,25,102,54,4,4,21,142,15,7,10,22,165,0,117,0,50,13,41,11,78,68,144,17,1004,269,37,4,126,56,187,0,37,7,51,38,3,92,141,10,10,5,7,0,150,16,4,6,13,3,51,3,6,249,66,3,0,21,18,125,13,18,64,24,10,4,3,10,26,29,189,5,4,32,48,6,2,220,6,15,4,44,2,4,70,4,16,9,63,3,639,7,36,74,1,9,9,41,4,168,10,70,18,139,42,167,94,38,3,18,3,6,81,20,574,3,3142,15,3,314,7,4,11,1,8,7,5,204,6,2,387,5,58,2,1,1,10,26,4,17,1,595,80,12,4,10,3,34,6,1,5,1,5,11,2,164,7,6,33,5,36,19,1,25,47,3,0,75,1,25,7,4,107,280,11,13,8,5,26,14,4,363,2,32,6,1,0,2,11,126,4,10,5,41,3,13537,1,7,0,105,14,17,80,5,3,5,2,56,22,39,0,1,1,22,52,8,1,18,3,6,174,11,23,0,16,13,0,10,392,5,4,6,22,57,48,49,8,45,8,3,7,2,3,26,11,22,13,6,3,0,5,43,136,5,38,6,115,8,0,2,567,3,37,2,11,4,102,2210,14,75,87,4,23,1,24,1,3,31,2,201,26,44,10,6,52,1,281,2,48,7,33,6,5,1,9,3,5,128,5,7,40,224,437,1,44,2,2,1,7,9,32,255,3,2,36,257,27,272,0,4,0,28,9,33,13,1,26,1,2,4,58,0,11,6,5,2,16,1,29,2,55,3,1,9,98,3,2,0,81,74,2,101,1,46,2,6,75,1,117,2,286,22,1,5,19,4,9,2,2,1,11,4,0,38,10,76,1,1,0,2,3,6,3,120,0,0,11,2,13,4,5,3,0,0,25,2,86,22,7,0,86,41,1,2,0,0,36,28,4,0,61,0,0,0,176,322,135,3,8,3,1,780,12,0,4,1,1,0,4,124,180,6,3,3,10,6,9,25,42,9,6,2,4,1,14,0,3,6,0,6,4,4,12,2,9,2,10,3,0,39,266,3,2,0,4,5,1,6,2,6548,3,13,2,3,3,1,13,24,3,7,50,1,4,1,0,2,51,1,0,406,2,10,4,0,78,103,4,1,1,75,6,8,3,18,4,23,10,0,1,3,9,138,131,3,6,17,8,1,4,0,37,22,60,6,29,1,21,1,3,66,46,0,53,8,0,33,3,0,2,2,2,9,12,18,1,0,0,3,8,1,17,3,0,2,0,17,2,29,3,0,15,0,1,502,93,39,236,1,72,10,52,8,10,3,75,14,2,10,4,0,71,2941,104,34,38,7,5,1,5,2,0,37,106,3,0,31,0,30,11,1,13,4,1,15,1,40,7,12,5,2,93,0,50,1,22,10,20,3,1,1,2,4,2,5,1,2566,4,25,85,1,1,5,44,0,8,1,0,0,5,600,7,83,13,5,1,9,16,3,15,0,13,5,11,5,2,0,1,1,8,9,3,1,104,76,1,95,4,66,34,11,0,4,3,16,0,6,16,3,20,11,1,75,8,1012,0,311,4,1,10,1,11,2,2,9,19,0,2,1,11,10,64,477,2,5,9,3,31,3,1,506,0,0,12,5,6,15,0,346,0,0,1,84,8,115,0,5273,13,35,1,9,77,6,73,15,2,18,413,9,61,2,1,2,0,1,9,8,4,8,7,5,2,4,4,0,2,2,13,411,3,41,1,4,18,5,3,0,67,7,4,4,179,2,4,3,96,2,1,1,1,9,0,822,0,1,26,44,7,25,0,0,1,10,1406,5,25,4,0,0,0,0,1,0,11,0,10,77,3,224,8,2,0,2226,4,2,0,6,0,1,1,14,29,21,6,18,363,5,10,11,16,6,65,37,0,3,1,0,8,4,19,18,252,0,0,2,14,2,1,1,1,3,5,1,3,17,3,5,7,0,3,11,3,4816,0,0,3,0,11,18,0,35,1,1,0,1,3,1,1,2,25,1,2,2,0,1,0,115,4,9,5,1,0,15,4,57,2,3,0,4,3,1,27,17,29,1,1,0,21,9,43,0,129,3,1,2,1,5,2,1,20,21,47,0,15,31,286,0,2,19,11,5,3,1,0,1,2,1,8,8,0,114,2,0,38,3,0,6,0,43,26,47,2,16,0,11,1,0,2,3,0,1,1,106,0,7,24,2,0,2,1,81,1,3,3,30,10,2,4,0,0,1,19,0,5,21,3,0,0,16,27,11,0,52,1,13,0,1,1,6,2,0,13,21,32,4,80,131,0,2,27,2,1,6,3,2,688,1,1,5,2,0,0,144,16,1,6,11,5,3,3,0,5,1,1,8,358,13,2,1,0,3,19,0,14,10,62,1,2,2,13,1,96,1,8,1,22,4,18,1,1,4,2,1,0,4,1,0,0,1,5,2,18,2,6,0,15,0,3,0,3,4,0,1,11,44,3,3,599,7,1,97,144,243,0,7,1,9,1,0,1,1,3,0,8,0,0,4,1,6,1,5,1,0,5,2,0,0,6,26,2,3,0,3,1,1,10,3,0,4,4,1,2,0,17,0,0,0,5,30,12,2,3,0,0,1,4,15,0,1,6,2,0,3,73,7,0,0,1,0,0,0,0,0,230,7,3,2,0,9,0,4,9,9,0,41,3,2,1,1,10,0,0,14,0,31,1,4,2,1468,0,2,798,2,0,2,2,0,165,13,11,17,2,11,20,0,4,3056,0,0,2,1,8,3,10,0,1,1,0,3,0,1,58,0,11,9,0,7,13,61,0,2,0,11,14,2,1,0,1,6,2,1,1,80,0,1535,0,1,9,2,2,41,4,1,0,33,5,7,10,0,37,0,16,1,8,0,7,2,0,0,0,2,19,20,48,7,5,16,1,6,4,0,0,0,12,0,1,272,0,3,2,2,18,0,4,0,0,1,2,62,6,0,0,4,1,0,2,0,6,2,1,0,0,0,82,0,0,1,1,11,1,0,1,2,0,1,10,1,7,0,0,1,0,1,1,2,0,4,0,5,0,0,0,4,7,0,0,1,3,0,1,38,14,0,0,1,117,10,0,0,3,21,13,3,0,0,1,1,3,6,0,0,1,0,8,0,1,1,0,0,80,2,1,11,2,10,1,4,3,0,0,1,0,73,1,0,5,0,0,10,6,0,88,5,1,0,2,5,1,1,2,32,2,26,21,5,1,0,1,2,12,1,0,6,0,14,2,6,15,0,4,0,0,10,1,923,19,0,0,0,4,24,55,0,1,1,6,1,2,0,6,1,0,10,0,14,0,0,0,4,1,0,1203,0,19,0,0,0,7,3,1,22,2,0,1,28,2,6,7,16,0,1,0,0,0,9,1,25,53,14,1,0,1,1,123,0,1,1,1,1,0,0,2,0,13,100,0,12,2,0,5,0,7,1,1402,4,3,0,2,14,4,0,39,1,1,0,3,2,1,2,54,3,15,7,0,26,0,0,0,63,14,0,0,27,1699,1,227,0,2,1,1,26,7,148,0,2,4,3,2,0,0,1,4,0,0,11,4,2,1,0,4,1,3,21,2,1,1,0,11,1,1,0,1,0,2,0,3,0,0,0,0,0,1,3,23,0,9,102,1,14,1,0,2,0,2,6,1,0,20,2,1,0,6,0,0,3,0,9,5,0,408,0,1,35,0,0,0,3,0,0,1,14,6,2,6,0,1,0,0,5,0,6,3,0,2,0,0,0,0,390,2,0,172,0,3,0,13,3,7,80,1,5,2,2,9,3,0,2,2,2,2,6,1,0,0,0,115,0,5,0,0,7,665,4,0,8,0,33,4,0,1,1,0,7,0,3,0,3,5,0,0,1,0,1,3,1,2,782,1,9,0,0,2,0,0,5,1,0,0,2,1,0,131,85,1,0,0,5,0,4,1,0,0,3,1,8,0,1,22,21,0,1,5,3,8,0,0,2,1067,2,0,0,0,14,0,0,12,17,1,0,1,4,0,1,0,0,2,3,16,1,1,0,4,89,0,1,7,1,69,0,0,1,135,0,0,0,0,5,0,9,5,8,0,0,0,0,0,0,1,3,0,2,22,8,4,2,0,5,9,2,16,9,17,20,31,0,1,1,15,0,0,0,0,4,0,24,1,1,4,9,0,0,1,4,0,0,0,0,0,1080,2,0,1,0,0,0,0,7,2,4,0,5,1,0,0,10,0,1,2,7,1,44,0,0,25,5,423,0,212,0,18,4,0,3,0,0,2,56,0,0,3,7,0,2,1,1,0,0,13,2,2,14,0,6,70,17,44,8,0,9,0,0,2,42,0,0,1,2,0,0,1,2,0,1,1,124,0,1,1,9,1,1,19,0,0,2,72,1,1,0,0,4,1,1,1,1,0,0,0,0,0,2,360,12,0,0,1,0,1,0,0,1,14,3,584,7,2,1,6,0,0,0,0,0,3,2,0,1,1,0,4,9,0,2,2,0,1,1,0,0,1,2,0,0,0,4,0,1,0,14,0,2,1,29,2,1,0,4,0,0,0,1,0,2,0,0,204,1,11,0,2,2,152,0,1,0,0,1,3,0,8,20,0,3,5,0,13,0,27,0,5,0,0,0,3,4,0,3,0,1,0,0,0,2,0,0,0,1,313,9,3,0,0,1,1,1,6,1,115,0,4,1,2,4,0,0,0,1,0,2,1,0,0,0,1,0,1,0,1,0,3,0,2,0,2,2,1,0,21,0,3,0,2,1,8,3,7,8,0,1,2,0,0,0,0,1,0,2,3,0,30,7,1,5,0,0,0,0,8,49,8,1,0,5,0,0,0,0,0,0,1,0,0,0,0,0,0,1,0,0,1,1,1,0,1,0,1,0,0,1,1,3,0,1,0,1,1,0,0,0,0,0,5,3,0,0,0,0,0,1,1,0,1,0,1,1,0,4,1,0,0,0,0,2,10,0,0,4,1,1,0,0,1,0,0,0,0,0,6,19,0,0,0,0,0,1,2,5,0,0,2,1,0,0,0,0,2,22,0,1,1,1,13,2,1,2,0,0,17,0,5,0,21,0,1,0,0,1,34,0,1224,0,0,13,0,1,0,0,0,0,1,3,1,0,1,0,0,0,55,0,0,0,0,0,0,0,1,0,0,0,0,0,0,0,0,0,4,1,2,6,1,8,0,0,3,1,0,1,5,1,0,1,0,0,8,2,0,0,0,0,0,1,1,1,0,0,5,0,0,6,0,0,0,0,0,0,1,0,6,0,0,1,0,0,0,6,0,1,0,0,0,0,0,0,0,0,0,9,0,6,1,0,3,0,1,0,0,0,1028,24,1,0,0,7,0,10,4,3,0,0,0,3,1,5,3,3,0,0,0,0,4,0,6,0,0,2,1,0,2,1,2,1,0,0,0,0,3,0,0,2,0,8,0,1,0,348,0,0,1,0,1,24,0,1,0,1,0,0,0,0,0,2,0,14,0,0,0,0,1,0,0,2,0,1,0,0,0,1,0,1,0,0,36,0,0,4,0,0,0,0,0,0,1,0,1,0,0,0,8,0,0,0,0,0,0,2,57,0,1,5,1,4,0,1,0,1,0,0,28,0,1,28,0,1,5,0,0,0,0,0,5,0,1,0,2,0,0,1,0,0,0,0,0,0,0,1,1,411,0,1,0,1,1,0,0,0,0,1,7,12,0,0,0,0,0,0,0,67,9,148,3,5,0,0,0,7,0,0,2,0,0,0,0,0,0,0,2,2,0,0,0,0,0,0,11,1,1,1,0,0,2,650,2,0,0,1,1,8,11,0,18,0,0,4,2,0,0,0,0,1,0,3,0,0,34,0,0,1,0,0,36,649,0,0,0,24,1,0,1,1,0,1,1,1,0,1,0,0,0,0,8,1,0,2,24,6,1,0,0,0,0,0,0,0,0,0,5,2,0,0,0,0,0,0,0,0,1,1,2,121,0,0,44,1,1,0,0,0,0,0,0,0,0,0,0,0,3,0,0,0,1,0,9,1,1,2,12,1,0,1,7,587,0,0,0,0,0,0,0,1,0,0,0,6,1,11,0,2,0,0,16,1,0,8,1,0,2,1,0,2,0,107,0,0,2,0,0,1,0,0,0,0,1,0,0,0,0,0,1,0,4,0,0,0,2,0,0,0,0,0,0,0,0,36,0,0,0,0,0,0,0,0,11,0,0,1,0,1,0,0,10,0,0,76,3,2,2,0,14,4,0,0,1,0,0,0,0,10,1,0,1,11,0,7,0,8,7,0,2,0,0,1,0,8,0,0,0,0,1,1,0,2,2,0,2,0,59,0,1,0,0,1,0,7,0,1,0,0,0,0,3,2,0,0,0,0,0,11,0,0,0,0,2,1,0,0,0,0,0,0,0,0,0,0,0,2,0,0,13,0,0,0,1,0,0,1,0,1,0,0,0,1,6,0,0,0,0,1,0,0,0,4,1,0,3,0,0,0,0,0,0,0,0,1,1,0,0,0,2,0,0,0,0,0,1,1,0,3,0,1,0,0,5,0,1,0,0,0,0,0,0,0,1,1,8,1,0,0,7,1,0,0,0,0,0,2,1,0,0,0,0,0,0,0,51,0,2,2,0,0,12,0,0,0,0,4,0,1,0,0,0,1,0,0,0,0,149,0,0,0,0,0,0,0,0,0,0,0,0,0,0,0,0,1,0,0,0,3,0,0,0,0,1,3,1,68,3,1,0,0,0,0,0,0,0,0,0,0,0,0,0,17,0,0,0,0,1,1,19,1,0,0,0,0,0,0,0,0,1,0,0,0,0,10,0,0,0,6,0,0,1,0,0,0,0,0,1,0,0,0,0,0,0,0,0,0,0,3,1,0,0,0,2,0,0,0,0,0,0,0,0,0,0,0,0,0,0,0,0,0,0,0,0,0,1,0,0,1,0,0,0,0,1,2,0,7,0,0,0,0,0,0,0,0,0,0,0,1,1,0,0,0,0,0,0,0,0,0,0,0,57,0,0,0,1,8,0,0,0,5,0,0,1,0,1,0,4,0,0,1,0,0,0,1,0,0,0,0,0,0,0,0,0,0,0,0,0,0,0,0,0,0,0,0,0,0,0,0,0,0,4,0,0,0,2,0,0,0,0,0,1,1,0,0,0,0,0,0,0,0,2,0,0,0,0,0,0,47,0,1,0,0,0,0,0,4,1,0,0,0,2,0,0,188,0,0,0,0,0,0,0,3,0,0,0,0,1,2,0,0,185,1,0,0,0,0,0,0,0,0,0,0,1,0,0,0,0,1,0,0,0,0,0,0,0,0,3,0,0,0,1,0,0,0,0,0,0,0,0,0,0,0,18,0,0,0,0,0,0,0,0,0,0,5,0,0,0,1,0,0,0,0,0,0,0,0,0,0,0,0,0,0,0,0,0,0,1,0,0,0,0,0,0,0,0,0,0,0,2,0,0,0,0,0,0,0,0,0,0,0,0,0,0,0,0,0,0,0,1,0,0,0,3,0,0,0,0,0,0,0,0,0,0,0,0,0,0,0,0,0,0,0,0,0,0,0,0,0,0,0,0,0
"Pancreatic Cancer",2601,4130,908,8310,216,2257,267,242,1456,486,269,2516,156,356,250,224,2173,786,266,1168,700,187,10381,696,74,55,1049,600,875,64,546,1056,147,25,172,333,287,77,505,82,5428,1665,296,1076,293,1387,34,13,836,1117,112,23,122,2001,317,133,449,502,1450,4125,2242,334,196,752,3181,809,5287,669,48,81,1091,154,117,63,216,322,42,830,121,1754,425,2880,12460,807,1330,26,694,128,24,187,134,856,2929,34,636,35,171,40,24,430,481,288,2789,34,117,1197,529,79,41,3268,387,23,84,368,165,32,252,300,467,102,42,31,53,1201,93,569,4563,36,114,259,276,1058,530,114,151,815,191,49,220,1619,547,436,80,72,417,342,67,357,13,103,1590,42,700,84,160,785,610,923,818,37,12,47,16,32,16,24,1783,118,66,162,1102,19,40,10742,144,25,72,100,108,26,21,3130,1157,51,54,138,21,55,21,81,138,21,37,50,13,631,61,56,44,462,6,7,582,415,3,89,223,1527,20,1829,89,55,1242,152,33,361,712,15,401,44,613,111,11,36,23,44,78,1196,264,142,87,231,150,28,25,33,2284,1795,13,22,49,6,1375,103,14,143,43,35,152,87,71,25,78,7,190,509,21,431,61,202,239,12,71,824,373,5,489,236,237,34,376,203,41,25,9,1,89,46,10,267,335,51,75,3339,17,12,131,7,13,13,14,1,14747,92,33,249,13,14,37,11,9,2201,171,350,25,356,63,27,612,31,8,5,297,56,343,55,6,15,3745,8,155,10,66,33,30,115,1189,31,12,18,361,66,158,9,14,17,9,2,0,164,500,77,177,79,119,6,59,37,17,8,20,6,8,8,28,101,427,75,5,25,7,8,83,0,466,257,9,321,0,2,3,1071,95,9,40,13,21,11,26,153,74,78,197,463,5,12,39,96,8,107,13,125,1,26,7,192,438,1,50,266,1438,1116,21,11,175,2,22,56,233,12,27,5,16,304,53,36,10,60,36,10,93,33,39,58,6,13,5,138,3,26,0,199,40,83,5,5,3,8,1,100,24,3,3,48,22,529,16,12,9,26,8,69,734,134,3,1,2,15,98,11,117,16,4,6,10,98,392,14,1,25,12,163,5,11,171,83,33,56,45,8,1,129,5,231,10,1,13,11,79,14,221,20,129,4,259,5,28,56,2,20,52,2,122,18,114,11,3,3,664,15,4,135,86,11,0,19,21,44,27,21,30,20,29,57,25,477,5,41,3,11,5,20,175,349,22,30,114,10,34,221,139,101,69,0,641,21,23,46,254,11,2,8,5,1,106,124,5780,43,9,161,55,10,8,28,8,18,21,4,11,9,45,4,330,89,0,3,19,1,7,4,35,3,25,22,13,2,62,0,11,6,128,4,84,35,7,17,23,37,10,87,7,20,104,43,5,27,31,8,388,1,29,30,4,21,7,263,45,7,14,24,97,997,200,510,16,12,1,20,1,62,2773,0,3006,94,576,20,4,29,20,12,237,3,21,42,336,465,8,1,19,55,2,17,8,6,0,176,3,206,7,0,4,14,4,10,28,22,1,7,25,93,11,8,21,1,2163,4,28,6,92,9,71,16,149,74,148,24,22,167,36,4,114,170,131,0,403,3,15,2,8,12,63,23,39,6,1,1,14,1,4,1,30,3,13,7,10,156,285,2,0,118,275,29,37,0,80,33,15,3,1,34,8,95,42,8,7,18,62,5,3,121,45,11,4,60,6,3,314,1,2,6,111,21,1701,8,6,152,3,7,6,37,7,49,5,12,30,118,313,9,3,33,4,3,2,2,27,24,10,8,2998,13,8,99,18,3,302,2,1,11,4,144,1,3,298,6,145,5,1,2,14,86,4,17,2,17,7,39,4,10,3,32,16,0,80,4,153,7,8,14749,3,11,4,0,19,12,3,4,3,0,1,18,0,352,4,3,256,480,1,16,5,2,25,13,29,108,6,8,5,2,0,0,15,38,2,445,63,305,1,186,0,1,2,42,19,24,51,3,4,6,10,98,3,129,1,2,1,21,82,10,16,189,1,6,60,23,3,0,6,2,0,4,272,9,12,24,81,115,14,147,16,31,5,12,35,2,2,12,9,14,17,1,7,1,2,15,36,7,37,2,540,10,0,3,346,6,34,8,20,16,130,60,5,25,38,5,10,2,18,2,51,8,0,135,128,438,0,34,30,2,149,0,55,3,59,1,2,1,22,5,22,163,43,2,31,216,144,0,49,2,7,1,7,14,6,15,1,3,125,152,22,15,2,2,2,196,10,215,14,0,13,2,4,9,21,1,110,2,6,0,63,3,12,2,96,11,6,12,423,79,2,3,17,17,2,79,0,118,57,5,6,0,4020,22,1,30,1,0,57,29,7,0,1,5,39,49,4,15,39,168,0,4,0,0,0,8,7,80,1,3,14,21,6,4,11,2,1,1,49,8,52,134,4,0,302,13,0,4,1,0,32,1676,8,4,23,3,3,2,108,12,179,4,18,7,1,45,0,4,1,1,0,0,3,60,86,1,7,3,1,11,7,21,30,16,9,2,0,5,7,0,64,1,0,6,0,10,9,0,7,2,13,1,0,29,169,6,2,0,3,5,6,1,0,1085,1,13,0,7,7,5,46,0,43,11,45,3,3,0,1,2,53,6,0,986,21,7,59,0,4,28,5,2,3,2,21,52,4,1,9,368,11,1,0,0,7,418,8,0,4,11,9,35,3,1,55,25,248,7,26,3,134,0,2,12,40,0,17,0,0,8654,2,1,0,6,33,12,12,20,0,5,1,0,26,29,414,1,0,4,2,16,2,6,1,4,21,0,1,82,97,6,3,4,24,8,33,9,13,0,1714,9,0,3,6,0,1,2021,26,19,19,1,271,1,74,5,0,23,71,2,0,14,1,75,1,0,42,4,19,5566,0,52,668,12,4,3,2,2,6,3,2927,3,7,1,6,0,1,1,2,27,0,349,8,2,108,12,2,8,361,2,82,2,1,1,29,111,5,17,9,1,0,0,9,9,3,1,10,18,5,20,1,0,0,1,7,0,16,0,1,192,3,23,8,20,10,6,8,3,12,21,0,1,28,1,19,26,7,54,7,9,0,10,11,4,8,0,0,2,4,11,5,1,0,0,735,3,85,19,46,15,50,6,38,1,0,44,0,0,8,4,1,18,1,13,1,1,0,47,2,3,0,36,15,2,2,3,31,535,23,5,0,4,51,8,1,1,6,8,0,1,2,10,2,11,16,44,3,4,14,0,3,1,9,14,1,36,2,8,28,3,4,2,1,6,6,0,3,1,4,37,40,0,2,1,20,27,5,15,14,3,72,3,8,4,1,3,4,9,46,3,12,9,1,38,0,0,1,2,11,7,9,30,3,127,10,2,1,35,2,0,3,6,0,1,2,2,8,63,27,1,132,5,2,73,1,8,19,9,0,17,1,0,2,1,29,5,8,1,1,0,7,0,0,0,4,1,41,0,23,31,69,5,5,1,0,1,7,309,0,1,4,3,14,8,1,18,0,2,0,3,0,2,4,0,14,0,1,0,3,3,1,1,1,11,0,3,0,16,3,11,2,4,0,5,3,3,17,1,21,13,3,1,113,11,43,0,109,2,0,1,0,2,1,101,1011,2,28,2,18,36,9,3,1,10,1,222,14,2,0,3,8,1,0,74,0,44,3,0,12,3,3,66,0,32,7,41,8,53,1,129,0,0,1,1,0,0,1,10,0,3,46,0,5,0,1,92,0,12,2,8,143,0,1,1,0,1,21,0,1,11,1,2,0,29,4,54,0,0,2,19,1,1,4,4,1,0,27,11,57,13,9,79,144,3,45,0,18,11,17,4,167,1,7,6,0,0,0,5,7,0,1,0,3,18,1,0,13,8,1,10,2,4,2,9,0,507,2,2,5,3,2,0,2,0,4,0,104,0,0,0,9,4,80,0,0,0,3,0,2,4,0,2,2,1,0,2,34,0,7,0,25,2,4,0,4,1,0,1,11,469,0,4,139,15,6,93,3,202,0,10,0,0,1,1,4,2,2,0,4,0,1,1,1,0,10,1,0,0,2,3,0,1,2,74,5,1,1,1,2,0,32,1,2,5,1,2,0,0,55,3,0,1,4,40,3,1,1,1,0,0,5,2,0,0,3,1,0,2,27,0,1,0,0,0,0,0,2,0,1,1,3,739,0,1,0,1,7,0,0,75,7,0,0,4,1,0,1,32,2,38,1,3,2,25,0,3,7,0,1,2,0,0,307,19,10,14,2,9,5,0,1,23,0,1,90,0,10,7,107,2,2,3,2,2,0,2,20,0,16,5,3,14,9,19,0,7,1,15,1,0,0,4,15,1,0,1,0,32,0,19,4,0,10,2,0,43,10,0,1,25,6,8,15,20,3454,1,12,0,30,0,22,6,0,0,1,7,75,1149,8,4,4,6,7,1,4,4,0,1,0,0,0,4,2,2,0,0,35,0,9,0,0,0,0,3,3,1,0,6,7,2,0,0,4,1,0,0,0,0,53,3,1,1,0,4,0,0,0,1,0,4,39,11,69,0,0,5,1,2,27,0,11,0,0,895,2,0,4,5,66,3,1,2,6,0,12,40,4,0,0,2,1,6,0,0,0,85,18,0,0,0,2,3,0,0,1,3,2,1,6,0,0,2,0,0,187,2,0,1,0,172,4,318,0,1,207,0,1,36,1,0,1,0,0,19,1,0,6,5,0,0,2,2,0,0,2,124,0,40,11,1,1,3,0,0,10,0,0,4,0,16,1,10,0,0,334,0,10,1,2,66,13,0,1,0,2,0,634,0,1,1,7,14,2,1,0,5,0,12,0,10,0,1,2,3,2,0,1051,0,3,0,0,1,1,0,0,9,0,3,1,454,3,3,15,9,1,2,0,0,1,6,1,0,9,1124,5,0,2,21,1,2,1,0,2,0,4,0,0,0,48,2,0,6,0,0,5,0,1,0,11,4,3,1,1,9,4,2,6,2,6,0,0,1,1,1,23,21,14,4,0,1289,0,4,1,0,15,0,0,16,622,1,157,0,1,1,0,36,132,11,1,2,214,2,4,1,0,0,4,0,0,13,6,30,3,1,6,0,1,79,0,0,0,0,14,6,1,2,0,0,15,0,2,2,0,38,0,0,2,8,2,0,1,214,48,7,3,2,0,0,6,3,0,1,36,1,1,0,6,0,4,0,0,8,2,0,1,0,1,2,0,1,0,0,0,1,1,4,11,14,25,2,7,5,0,3,0,32,1,3,1,0,0,0,2,11,2,0,8,0,0,18,12,2,6,44,1,2,0,1,15,3,0,2,5,0,1,0,0,0,2,1,39,5,2,0,0,3,3,2,0,5,0,0,11,0,3,0,0,2,0,75,2,2,10,0,0,0,1,1,2,3,0,14,0,13,1,0,0,0,0,1,0,0,0,0,2,0,12,2,7,0,2,69,0,0,0,0,0,12,2,43,0,0,15,15,0,1,0,1,6,1,0,2,875,0,0,0,0,13,0,0,6,19,1,1,1,1,0,1,0,0,3,1,9,1,0,1,3,20,2,1,28,1,12,1,0,19,14,0,0,0,60,0,0,16,10,12,0,1,0,0,0,1,0,0,0,1,157,3,0,1,2,9,3,2,12,14,51,2,9,1,0,2,6,0,0,1,2,6,0,7,0,1,14,5,1,0,0,18,1,0,5,0,1,292,2,1,0,1,1,0,3,31,1,8,0,9,7,1,0,5,0,3,4,1,1,52,22,1,3,0,38,1,5,6,0,6,0,0,0,0,1,14,0,3,2,6,3,3,0,0,4,0,30,1,118,11,0,1,3,6,52,8,0,43,0,0,1,63,0,0,1,9,0,0,0,6,0,0,0,36,0,3,59,21,0,2,3,1,1,1,1,0,1,0,1,2,23,2,0,2,0,0,1,0,0,2,622,1288,0,0,0,0,3,0,0,1,9,8,13,1,1,2,14,0,0,0,0,3,0,0,0,1,0,0,3,2,1,0,1,1,0,0,0,2,0,0,0,5,0,7,0,5,0,12,0,3,2,10,0,0,0,3,2,0,0,0,0,0,2,3,6,0,2,0,1,2,36,1,8,0,1,0,0,1,9,7,0,3,1,0,5,2,14,0,6,0,0,0,5,6,33,0,0,1,1,1,0,0,0,0,0,0,2,31,1,0,0,6,0,0,3,2,4,0,1,4,0,4,0,0,0,0,0,3,16,0,0,0,2,0,0,0,2,36,0,0,2,1,1,0,0,1,11,0,1,0,0,0,14,1,4,0,0,0,0,3,1,6,0,0,0,2,3,0,18,0,0,1,1,0,0,0,9,56,0,5,0,4,0,1,0,1,0,0,2,0,0,0,0,1,0,1,2,0,0,1,1,5,0,0,3,1,1,0,0,0,0,1,0,0,0,3,1,4,0,1,34,1,0,0,0,0,0,1,2,1,2,0,0,0,1,5,0,97,0,0,0,1,31,0,0,141,0,2,3,1,0,1,0,0,1,0,6,24,0,1,0,0,0,1,0,0,0,0,5,0,14,0,0,1,0,19,0,0,1,0,17,3,11,1,0,0,3,0,3,0,87,1,1,0,0,0,2,1,93,0,0,2,0,0,3,1,0,0,3,1,0,0,1,0,2,1,11,0,1,1,0,0,0,0,3,0,0,0,3,1,0,1,0,0,2,3,6,9,3,11,0,0,3,0,0,0,0,2,0,0,0,1,0,0,1,1,0,0,0,0,0,1,0,1,999,0,0,3,0,0,28,0,0,1,1,0,56,0,0,0,0,3,0,5,0,0,0,0,0,1,1,0,0,0,0,0,0,0,0,0,15,1,2,2,0,1,6,0,0,0,0,0,0,4,7,0,0,1,0,1,2,3,1,2,1,0,0,0,0,3,2,0,0,2,1,0,22,1,0,1,1,1,0,0,4,0,1,0,0,2,0,0,0,7,2,0,1,0,1,17,2,0,0,0,0,0,0,0,0,0,4,1,0,0,0,0,1,1,2,1,1,35,0,1,0,5,0,0,1,0,3,0,0,0,0,0,2,0,0,0,29,2,3,0,0,1,19,0,0,1,0,0,0,5,28,0,0,0,2,13,0,0,0,5,0,2,5,0,1,3,0,0,0,0,2,0,0,0,15,7,0,1,2,0,0,0,0,0,0,0,0,0,1,0,0,1,0,3,1,0,45,0,0,0,0,0,3,0,0,0,0,4,0,0,0,39,0,5,0,0,0,6,0,4,0,0,5,0,0,0,0,14,0,0,1,0,0,0,0,0,1,0,21,10,0,1,0,0,1,2,2,0,0,1,0,16,0,0,19,0,0,6,1,0,0,0,1,0,25,1,0,0,12,1,0,1,0,0,2,4,0,1,0,0,1,7,0,1,0,0,1,0,0,0,0,3,1,0,1,0,0,1,5,10,0,0,0,0,0,1,0,0,0,3,5,0,0,0,0,0,1,0,0,0,0,2,1,15,0,0,0,2,5,0,0,0,0,0,0,0,0,0,0,0,0,0,0,0,0,0,4,0,0,0,2,0,0,0,0,13,0,0,2,0,0,0,0,0,1,0,2,5,9,2,1,1,2,0,0,0,0,1,1,0,8,5,0,0,0,8,0,0,3,0,0,1,2,0,0,0,0,0,0,0,0,0,0,0,0,2,0,0,1,0,0,0,0,0,0,1,0,2,0,0,1,0,0,0,0,0,1,0,0,1,0,214,0,1,18,0,1,4,0,2,0,0,3,568,6,1,0,0,0,0,0,0,0,0,0,1,0,3,0,7,0,0,1,0,8,4,0,1,0,0,0,0,0,1,0,0,5,2,0,0,0,0,0,10,5,3,1,3,0,1,0,0,0,0,1,4,0,2,0,0,0,1,1,0,1,2,0,0,0,0,2,0,0,3,0,78,0,0,0,2,0,0,7,34,1,0,1,0,0,0,0,6,0,0,0,0,3,0,0,0,0,1,3,0,0,2,0,0,4,0,0,0,0,1,0,0,1,0,2,1,0,0,3,0,0,0,2,18,1,2,0,2,0,0,0,0,9,0,2,1,0,3,0,1,0,0,0,0,3,0,0,1,178,0,0,0,0,0,0,0,0,0,0,0,3,0,0,2,10,0,10,6,0,0,5,0,5,0,0,397,0,0,0,1,0,0,0,0,0,0,2,3,0,1,1,0,3,0,0,0,0,0,0,0,1,0,0,2,0,0,0,0,0,1,2,0,1,0,0,4,0,0,0,0,0,0,0,0,0,2,0,0,0,0,0,0,4,0,1,0,0,0,11,0,0,0,0,1,0,0,0,0,0,0,0,0,0,3,0,0,0,1,0,0,1,0,0,0,0,0,5,0,0,1,0,0,0,0,0,0,0,0,0,0,0,0,1,2,0,0,0,0,2,0,0,148,0,0,0,0,0,0,0,0,0,0,0,2,0,1,0,0,3,1,0,0,0,236,0,0,0,0,0,0,0,0,0,0,1,0,0,1,1,0,1,1,0,3,0,0,0,0,2,0,46,0,0,1,0,0,0,0,0,0,1,0,1,1,0,0,2,1,0,0,0,0,0,0,0,0,1,0,0,0,0,0,0,0,0,0,0,0,0,0,0,0,0,0,0,0,0,0,0,0,1,0,0,0,0,0,0,0,0,0,0,0,0,1,0,0,0,0,0,0,0,0,0,0,0,0,1,1,0,1,0,0,0,1,0,0,0,0,0,0,0,0,0,2,0,1,0,0,0,0,1,15,0,0,0,0,1,1,0,0,0,0,0,0,0,0,0,0,0,0,0,0,0,0,0,1,1,0,0,0,0,0,0,0,0,0,1,0,1,0,2,0,0,0,0,0,0,0,0,0,0,0,0,0,0,0,0,0,0,0,0,0,0,1,0,0,0,0,0,0,0,0,0,1,1,1,0,0,0,0,0,1,0,0,0,1,0,0,0,0,0,2,0,0,1,0,1,0,2,0,0,0,0,0,0,0,0,0,0,0,0,0,0,0,0,0,0,0,0,0,0,0,1,1,0,0,0,0,0,1,0,0,0,0,0,0,0,0,0,0,0,0,0,0,0,0,0,0,0,0,0,0
"Pheochromocytoma & Paraganglioma",455,314,4049,700,424,418,60,155,88,32,20,62,176,363,11,265,92,54,29,9,354,313,554,52,30,34,80,31,101,366,102,43,36,22,7,8,125,33,33,48,103,180,223,46,27,229,26,13,61,19,33,165,15,89,73,9,0,14,307,232,112,88,23,39,271,15,54,30,34,0,18,31,65,4,11,116,23,33,10,88,17,89,1179,89,571,4,25,67,18,39,32,68,13,17,97,385,13,5,2,17,1,47,227,0,9,45,94,410,23,111,4,181,20,82,15,5,15,0,5,652,5,51,9,47,7,23,88,3,163,15,12,87,24,4,11,23,19,16,10,39,23,15,75,10,16,14,18,40,45,14,65,343,26,54,13,79,27,28,26,5,7,9,202,14,3,42,42,8,149,39,91,64,8,29,41,6,14,403,12,64,0,42,7,1,9,69,3,15,22,22,71,43,49,36,193,248,14,3,11,121,9,2,21,9,5,93,35,278,2,39,1,2,136,9,39,9,19,104,3,30,52,25,61,25,22,28,10,37,8,4,2,51,57,7,4,2,112,14,4,10,8,2,166,8,20,5,4,11,1,213,16,1,4,69,12,36,10,12,6,9,34,0,75,8,14,1,3,9,53,10,11,23,7,38,2,0,0,0,118,19,680,7,35,6,2,22,7,28,91,4,91,2,8,8,21,12,1,3,7,6,7,7,8,143,3,149,11,9,33,9,4,1,17,39,16,46,5,59,82,0,53,0,15,2,9,7,15,20,78,0,6,7,9,19,1,4,14,0,2,7,14,1,10,4,14,6,3,5,5,0,2,11,4,1,5,0,12,26,1,285,13,8,2,4,2,7,0,0,0,40,0,65,0,4,13,2,2,1,175,0,10,4,3,259,4,1,0,34,4,7,4,37,0,0,5,5,9,0,2,1,0,3,3,0,4,1,25,5,17,6,0,0,18,14,4,4,0,5,12,7,12,3,11,9,2,14,1,0,0,7,2,7,7,31,1,0,7,9,5,1,0,0,31,3,6,7,6,0,19,9,30,67,4,9,2,0,0,2,10,24,59,12,3,3,7,32,19,7,3,14,4,5,1,4,135,6,6,10,9,6,0,4,1,0,0,12,19,4,25,5,29,8,9,3,7,1,16,9,1,5,8,0,2,4,0,62,0,3,17547,21,0,42,0,85,3,19,4,5,18,4,20,3,9,5,5,17,1,3,0,2,14,1,3,11,1,17,4,1,44,21,7,5,4,1,17547,11,2,41,1119,0,3,1,63,2,23,7,2,1,1,39,5,43,0,9,1,4,5,1,0,0,1,1,79,43,0,2,1,0,2,3,1,1,0,0,0,3,1,0,5,8,1,4,8,19,1,0,2,6,1,1,11,4,11,1,0,1,3,1,3,1,0,0,5,1,0,11,3,4,0,5,19,1,54,3,1,9,0,13,1,5,30,1,436,0,3,3,4,1,14,5,24,0,8,1,23,8,4,1,46,50,0,1,5,10,1,0,2,29,0,3,1,0,2,3,3,2,4,1,13,7,2,43,7,3,17,0,21,0,56,2,191,7,11,16,22,1,8,21,6,128,5,360,8,0,426,0,5,5,0,1,20,0,2,0,21,0,3,0,46,2,16,1,9,0,4,32,2,0,1,0,2,0,0,0,16,15,4,0,0,3,3,0,2,1,1,8,2,2,0,0,2,11,0,5,1,0,5,0,1,2,5,6,221,2,0,58,0,0,2,66,1,7,2,0,2,45,100,0,1,30,10,6,0,0,6,1,1,7,1,43,1,19,0,0,0,2,13,4,1,7,4,5,22,3,80,0,0,0,0,2,2,4,0,8,1,1,3,2,0,1,0,0,1,0,1,1,3,3,67,4,1,1,11,1,0,0,0,0,0,2,0,1,0,1,815,15,1,19,0,0,1,7,0,34,0,0,19,0,1,0,0,6,0,3,28,3,0,1,2,2,1,1,5,0,1,0,1,1,0,51,3,326,18,1,0,0,6,13,2,92,0,3,1,0,3,0,5,5,0,2,32,0,2,0,4,11,6,4,0,0,3,0,0,0,2,2,23,1,0,0,1,0,0,0,5,1,35,1,6,1,0,0,15,0,28,2,3,0,30,7,2,1,41,0,0,1,0,1,23,2,2,0,2,8,0,3,4,0,4,0,2,0,0,0,0,70,9,0,0,3,1,12,0,5,3,0,1,0,0,3,3,2,0,8,9,0,323,3,0,119,0,10,0,76,199,4,1,0,3,0,2,8,1,1,1,4,1,0,3,12,3,0,4,11,1,40,1,0,1,0,3,1,1,64,1,18,24,25,4,1,24,0,1,746,1,0,1,0,10,1,4,1,3,0,6,0,0,12,0,0,2,1,3,2,0,8,0,2,1,0,2,3,20,0,0,4,0,0,7,16,2,0,739,37,1,0,0,0,0,1,3,5,14,2,0,0,4,1,5,0,1,0,0,5,1,157,41,0,0,0,1,9,3,0,0,3,1,64,12,1,4,15,11,1,0,0,3,0,0,2,0,0,0,0,3,0,0,1,0,0,1,3,0,0,2,0,1,0,0,0,0,13,0,7,0,1,1,0,0,2,5,3,6,1,0,4,0,1,1,0,0,4,0,0,1,0,0,6,2,0,9,1,1,1,0,0,1,430,1,1,1,1,1,19,105,2,2,9,35,1,0,2,10,0,0,5,13,4,3,3,1,1,3,0,0,0,0,128,4,0,4,0,3,1,0,15,0,4,0,1,6,2,1,20,0,1,0,0,0,1,0,1,2,2,4,3,15,0,0,2,1,0,0,1,0,2,1217,2,1,0,0,0,0,17,0,12,3,0,0,5,4,3,0,1,32,0,0,0,0,1,0,0,0,1,4,54,0,2,1,0,12,0,4,1,1,0,2,1,8,5,0,40,0,0,3,1,1,26,4,0,7,4,2,3,6,3,1,0,2,0,0,16,0,2,3,12,3,0,1,2,2,0,3,1,0,3,0,0,0,1,0,0,0,0,0,8,2,5,0,6,0,1,1,4,5,11,1,0,2,2,5,0,1,1,0,2,2,1,2,0,0,0,1,0,0,1,0,0,0,0,0,2,466,16,1,1,5,0,2,0,0,7,0,0,2,1,7,1,3,7,1,1,0,0,0,0,0,0,0,1,6,0,9,0,0,0,8,0,3,18,1,0,0,2,2,0,0,1,1,0,4,3,0,3,0,0,0,4,0,7,0,2,0,1,7,1,1,0,0,1,0,0,2,0,0,12,2,0,2,0,0,23,1,20,0,0,3,0,1,0,0,0,0,1,4,0,1,1,0,1,1,0,8,0,5,2,1,0,1,10,0,0,0,6,0,0,0,1,0,0,3,4,3,2,1,0,2,1,0,1,1,1,1,0,0,2,0,5,0,0,0,0,0,0,0,1,0,1,0,3,0,0,1,0,0,0,0,14,0,0,0,0,0,11,0,1,1,0,1,5,0,1,0,0,0,2,0,0,141,0,9,0,0,1,0,7,0,0,0,0,1,0,1,55,2,2,4,1,0,17,0,0,6,0,1,0,6,0,5,0,0,0,18,0,1,0,0,0,0,2,3,0,3,0,0,33,4,2,0,1,0,2,0,0,0,0,0,0,0,7,0,9,4,0,1,1,0,1,0,1,2,0,2,23,0,1,0,0,23,1,0,0,0,0,0,0,0,0,0,1,0,0,0,0,0,4,1,1,0,2,0,1,0,0,0,1,0,1,1,3,1,638,0,2,0,3,0,3,2,1,0,1,0,0,4,1,0,2,0,0,6,0,1,1,0,3,13,0,1,0,0,0,1,3,1,5,0,1,0,2,1,0,1,0,2,1,2,1,0,2,0,0,2,0,0,0,1,1,1,0,2,0,0,0,0,0,0,1,71,0,1,1,1,0,0,0,0,1,0,2,0,0,5,0,13,0,0,0,0,0,2,0,0,0,0,602,0,0,0,51,0,285,0,7,1,0,1,0,1,1,1,0,0,0,14,1,0,0,0,1,0,0,0,0,1,0,1,0,0,8,2,0,0,0,0,0,5,0,0,0,0,0,1,1,10,0,0,0,1,2,3,0,0,1,1,0,0,0,0,0,2,0,0,1,0,1,0,0,0,1,0,0,0,0,0,0,1,1,2,0,7,0,1,0,0,16,0,2,1,0,1,0,1,0,0,5,13,1,3,8,0,0,0,0,0,1,0,0,0,2,0,1,0,0,0,0,0,5,0,0,0,4,0,3,3,0,0,0,0,1,0,0,0,0,1,0,2,21,0,2,0,1,0,5,3,0,0,0,0,0,0,0,1,1,0,8,0,0,26,0,0,7,0,1,1,2,2,2,0,8,100,0,0,0,5,0,11,0,0,2,0,2,6,33,2,0,1,0,0,1,0,0,0,0,1,0,0,0,0,0,0,0,4,0,0,0,0,0,0,5,3,0,0,0,0,0,0,0,1,0,0,0,0,0,9,2,0,2,2,2,0,0,1,0,0,1,3,1,0,0,4,0,0,0,1,0,0,0,0,0,0,11,0,0,2,3,0,1,0,0,0,337,1,0,0,2,0,1,1,0,0,273,4,1,0,0,0,0,0,0,0,1,0,0,1,0,0,0,1,0,4,1,2,0,0,0,1,0,0,0,0,0,0,0,0,0,0,0,0,0,1,0,3,32,0,0,1,0,0,0,0,2,2,0,1,0,8,0,0,4,3,0,0,2,0,3,0,2,1,0,0,0,0,2,0,2,1,0,0,0,2,0,11,0,1,11,0,0,0,1,0,0,0,1,0,2,0,0,0,2,1,1,2,0,0,0,0,1,2,1,0,0,0,1,0,4,0,0,0,3,0,0,1,0,0,5,0,0,2,45,0,0,0,1,0,0,0,0,0,0,1,0,0,0,4,0,0,1,0,0,0,0,0,0,1,2,1,0,0,3,0,0,2,0,1,0,1,0,5,9,0,44,1,0,0,1,0,0,0,0,1,0,0,0,0,1,1,0,1,0,0,3,108,3,0,0,4,0,0,0,0,1,1,0,0,18,8,0,0,0,0,0,0,1,0,0,0,0,7,0,0,0,0,0,113,0,0,0,0,2,0,0,0,0,0,0,0,33,3,5,0,0,0,0,5,1,0,0,0,0,2,0,5,0,0,1,0,0,0,0,0,0,0,0,0,0,0,0,0,0,1,1,0,0,16,0,0,1,0,0,1,0,1,1,1,0,1,0,0,2,0,0,0,0,0,0,0,0,6,0,0,0,4,0,1,0,0,0,0,1,3,0,0,0,1,1,15,2,0,0,2,0,0,1,0,1,0,0,0,0,0,2,0,2,2,2,0,0,1,0,0,0,0,3,1,2,1,0,0,2,0,0,0,0,0,1,1,0,3,0,19,0,21,0,0,0,0,1,0,0,4,0,0,0,0,6,0,0,3,5,0,0,0,0,6,2,0,2,1,0,0,0,0,4,0,0,0,3,0,0,0,0,0,1,0,0,0,0,0,0,0,0,3,3,0,2,4,0,4,0,0,0,1,0,0,1,0,0,0,5,24,1,0,0,0,0,0,2,0,1,1,3,83,1,0,3,0,0,8,0,2,7,1,0,0,0,0,0,3,0,0,0,0,0,0,0,0,1,1,1,0,0,0,2,0,0,0,0,7,10,0,0,1,0,0,0,0,3,0,0,1,1,0,0,0,0,0,1,0,0,0,1,0,0,0,0,0,1,1,0,0,0,0,0,1,0,1,0,0,0,0,1,0,1,0,0,0,0,5,0,13,0,0,0,0,4,0,1,2,491,0,0,0,1,0,0,0,0,0,0,0,0,0,0,0,1,1,0,1,1,0,0,0,0,3,0,1,0,0,0,0,0,0,0,0,0,0,0,0,0,0,0,3,22,0,0,1,0,0,0,0,0,2,0,0,6,0,0,6,0,1,0,0,1,0,0,0,1,0,0,2,0,0,0,3,0,0,0,0,0,0,0,0,0,0,0,0,1,1,4,1,6,0,0,4,0,0,3,0,0,2,0,0,0,0,2,0,0,0,0,1,0,5,0,0,0,0,0,0,0,0,0,0,0,0,0,3,0,0,0,1,0,0,0,0,1,1,0,0,2,0,0,0,1,0,0,0,0,0,3,0,0,0,0,0,0,2,0,0,0,0,0,0,0,0,0,0,0,0,0,0,0,0,0,18,0,0,0,0,0,0,0,0,0,0,0,0,0,3,0,2,0,0,14,0,0,2,0,0,2,0,1,0,0,0,0,0,2,39,0,1,0,0,1,1,0,0,0,15,2,0,1,0,6,1,1,0,0,0,0,0,0,0,0,2,0,0,0,0,0,0,0,1,3,0,0,0,0,0,0,0,1,0,0,1,0,0,0,0,0,0,0,0,0,0,0,0,0,0,0,0,0,28,0,0,0,1,1,0,1,0,0,0,0,2,0,0,0,0,0,5,0,0,0,0,0,0,0,1,0,0,5,0,0,0,1,0,0,0,5,0,0,0,0,0,0,0,16,0,2,0,0,1,0,0,0,0,0,0,0,0,0,8,0,0,0,0,1,1,0,0,0,0,0,0,0,3,0,0,0,0,0,0,0,1,1,0,0,5,0,1,2,0,0,0,0,0,0,0,0,0,0,0,0,0,0,0,1,0,0,0,71,0,1,0,0,0,0,0,0,0,0,0,0,0,0,0,0,0,0,0,0,0,0,0,0,11,0,0,0,0,0,0,0,0,1,1,0,0,0,0,0,0,0,1,1,0,0,1,0,0,0,1,0,0,0,0,0,0,0,0,0,0,0,1,0,0,0,2,0,0,0,0,0,0,0,0,1,2,1,0,0,0,0,0,0,1,0,0,0,0,1,2,2,0,1,1,0,1,0,0,0,0,0,0,0,0,0,1,1,0,0,5,0,0,0,1,0,0,0,0,0,0,0,0,1,0,0,0,0,0,0,1,1,0,0,0,0,0,0,1,0,0,0,0,0,0,0,0,0,0,0,0,0,0,0,0,0,0,0,0,0,1,0,0,0,0,0,58,0,0,0,1,0,0,0,5,1,1,0,0,0,0,1,0,1,0,0,0,0,0,2,0,0,0,0,0,1,2,0,188,0,0,0,0,0,0,0,0,0,0,0,0,0,0,0,0,0,0,1,0,0,0,0,0,0,0,0,0,0,3,0,0,0,0,0,0,0,0,0,0,0,0,2,0,0,0,0,0,0,0,0,0,0,0,0,0,0,0,0,0,0,0,0,4,0,0,0,0,0,0,0,1,0,3,0,0,9,0,0,0,0,0,0,2,0,0,0,0,0,0,0,0,0,2,10,0,0,0,0,0,0,0,0,0,0,6,0,0,1,1,0,1,0,0,0,0,0,0,0,0,0,0,0,0,53,0,0,10,0,0,0,0,0,0,0,1,0,0,0,0,0,0,0,0,0,1,0,0,1,0,0,0,0,0,0,0,0,0,0,0,1,0,0,0,0,0,0,0,0,0,0,0,0,0,1,0,0,0,0,0,0,2,0,1,0,0,0,0,0,0,0,0,5,0,0,0,0,0,0,0,0,0,0,0,0,0,1,0,0,0,0,0,0,0,0,0,1,0,0,1,0,0,0,0,0,0,0,0,0,0,0,0,1,0,1,0,0,0,0,0,0,0,0,0,0,0,0,0,0,0,0,0,1,0,0,0,0,0,0,0,0,0,0,0,0,0,0,0,13,0,0,0,0,0,0,0,0,0,0,0,0,0,0,0,1,0,0,0,0,0,0,0,0,0,0,0,0,0,0,0,0,1,0,0,0,0,0,0,0,0,0,0,0,0,0,0,0,0,0,0,0,0,0,0,1,0,0,0,0,2,0,0,0,0,0,0,1,1,0,0,0,1,1,0,0,0,0,0,0,0,0,4,0,0,0,0,5,0,0,0,0,0,0,0,0,0,0,0,0,0,1,0,0,0,0,0,0,0,0,0,0,0,0,0,0,0,0,0,0,0,0,0,0,0,0,0,0,0,0,0,0,0,0,0,0,0,0,0,1,0,0,0,0,1,0,0,0,28,0,0,0,0,0,0,0,0,0,0,0,0,0,0,0,1,0,0,0,0,0,0,5,0,0,0,21,0,0,0,0,0,0,0,1,0,0,0,0,0,0,0,0,0,0,0,0,0,0,0,0,0,0,0,0,0,0,0,0,0,0,0,0,1,0,0,26,0,0,0,0,0,0,0,0,0,1,0,0,0,0,0,0,0,0,0,0,0,0,2,0,0,0,0,0,0,0,1,0,0,0,0,0,0,0,0,0,0,0,0,0,0,0,0,0,0,0,4,0,0,0,0,0,0,0,0,0,0,0,0,0,0,0,0,1,0,0,0,0,0,0,0,0,0,0,0,0,0,0,0,0,0,0,0,0,0,0,0,0,0,0,0,0,0,0,0,1,0,0,0,0,0,0,4,0,0,0,0,0,0,0,0,0,0,0,0,0,0,0,0,0,0,0,0,0,0,0,0,0,0,0,0,0,0,0,0,0,0,0,0,0,0,0,0,0,0,0,0,0,0,0,0,0,0,0,0,0,0,0,0,0,0,0,0,0,0,0,0,0,0,0,0,0,0,0,0,0,0,0,0,0,1,0,0,0,0,0,0,0,0,0,0,0,0,0,0,0,0,0,0,6,0,0,0,0,0,0,0,0,0,0,0,0,0,0,0,1,0,0,0,0,1,0,0,0,0,0,0,0,0,0,0,0,0,0,0,0,0,0,0,0,0,0,0,0,0,0,0,0,0,0,0,0,0,0,0,0,0,0,0,0,0,0,0,0,0,0,0,0,0,0,0,0,0,0,0,0,0,0,0,0,0,0,0,0,0,0,0,0,0,0,0,0,0,0,0,0,0,0,0,0,0,0,0,0,0,0,0,0,0,0,0,0,0,0,0,0,0,0,1,0,0,1,0,0,0,0,0,0,0,0,0,0,0,0,0,0,0,0,0,0,0,0,0,0,0,0,0,0,0,0,0,0,0,0,0,0,0,0,0,0,0,0,0,0,0,0,0,0,0,0,0,0
"Prostate Cancer",2595,1419,1225,15461,539,1741,322,486,2115,613,452,678,464,525,585,404,2984,1315,269,376,1052,434,15933,1148,305,77,567,495,537,100,482,849,226,157,399,321,400,168,433,198,6443,2340,515,490,310,1417,52,51,1027,202,62,28,275,742,98,210,83,272,3181,449,4007,107,187,669,7520,372,1090,725,51,97,209,61,185,54,149,1343,173,1569,60,711,658,2648,1311,521,11287,66,923,163,131,119,184,1169,638,30,953,35,202,422,109,252,118,302,268,64,143,405,311,165,90,4274,77,29,1251,608,327,43,239,88,138,145,47,102,86,1308,171,292,4753,73,100,194,65,375,588,125,294,238,317,37,380,66,45,300,118,110,131,175,141,269,59,73,1995,34,448,92,147,189,703,997,233,44,49,77,15,77,37,79,1709,202,93,185,628,19,33,124,73,40,141,80,97,40,48,4710,773,11,50,208,127,100,66,69,193,40,53,95,14,302,75,119,750,270,29,4,399,66,9,48,246,2273,35,1753,73,61,2520,450,48,1136,352,14,43,41,130,27,14,19,38,39,71,1451,131,104,129,493,86,57,372,31,22,2697,128,18,80,2,1194,205,16,157,45,41,142,47,98,22,78,25,224,853,15,410,83,270,86,22,67,136,265,3272,333,379,479,32,99,315,143,43,8,15,43,34,16,368,439,81,24,85,15,16,348,6,15,155,11,3,743,44,359,40,47,47,38,22,16,60,45,70,70,70,49,4,186,23,16,14,588,33,501,68,12,26,544,10,39,4,47,13,56,212,35,326,15,57,39,70,237,32,30,52,29,6,1,241,176,43,140,201,151,2,225,57,13,2,58,2,6,12,28,24,7,58,11,36,7,12,117,2,93,110,9,172,2,3,8,840,17,32,49,94,52,14,29,28,47,113,44,91,24,71,69,41,2553,51,15,200,3,45,3,128,29,5,233,45,197,35,72,25,102,8,28,59,201,17,20,9,26,735,26,14,6,48,416,8,177,33,14,78,13,27,21,27,11,17,7,15,10908,29,10,13,7,18,4,27,16,2,12,27,14,22,20,53,6,11,23,1261,301,277,6,3,10,14,52,14,20,9,7,3086,14,214,500,3,4,19,25,68,20,262,59,49,17,32,9,11,32,51,6,142,15,1,18,42,172,10,137,8,110,8,222,16,23,59,6,18,53,8,242,2,11,7,23,5,118,6,7,170,152,8,14,49,17,36,156,16,123,61,20,41,22,824,6,26,6,6,65,34,204,230,11,29,59,32,63,541,1588,60,122,3,112,99,51,22,90,10,3,13,5,2,118,74,43,24,18,49,58,22,159,25,11,48,18,17,18,8,30,2,384,47,1,12,215,3,23,3,36,4,12,53,274,121,37,21,5,9,19,7,6,22,11,14,56,69,16,16,23,59,112,11,11,33,29,33,19,1,97,9,2,76,6,374,6,25,13,15,57,14,37,398,30,18,0,20,6,17,349,13,901,12,26,16,3,39,681,19,150,8,9,24,249,25,8,4,84,6,41,20,5,2,0,207,2,22,10,1,4,58,7,6,30,208,1,9,499,34,19,5,10,7,136,6,295,4,50,140,42,32,51,48,33,14,21,200,41,6,148,51,33,4,21,8,52,134,4,91,280,22,38,17,0,1,19,5,3,5,17,19,1273,7,64,162,117,2,1,30,20,116,23,425,183,135,22,5,3,8,10,37,46,11,12,33,93,8,2,81,15,16,19,40,10,3,54,11,3,20,62,8,210,53,12,26,2,15,3,59,26,99,7,463,44,87,104,34,11,50,5,13,6,2,17,20,71,17,329,48,7,480,21,2,11,3,4,4,6,159,2,4,320,21,80,5,13,60,14,21,1,14,7,19,13,20,5,210,5,26,1,15,9,6,2,2,3,142,6,14,46,3,10,20,3,25,8,5,0,34,3,29,1,14,87,1180,858,22,6,6,31,1,3,146,1,34,8,1,0,1,200,40,11,9,44,14,5,186,3,4,0,57,322,4,70,8,6,9,5,98,3,29,1,14,1,47,63,10,3,28,1,9,53,15,5,0,6,0,0,6,259,39,122,12,18,27,41,94,12,114,2,8,22,3,7,12,8,44,13,2,8,2,2,15,43,7,39,0,114,7,1,12,261,3,18,4,12,1,66,171,3,24,23,0,15,2,54,4,2,12,13,72,35,613,0,10,37,2,196,4,17,4,16,12,2,1,31,1,11,76,6,5,80,32,108,2,23,8,8,4,8,14,6,6,1,6,21,215,22,29,1,18,3,78,4,174,27,6,35,5,7,10,432,2,7,4,20,1,20,2,7,4,38,30,2,16,207,9,4,0,23,43,3,68,3,30,1,3,76,0,10,2,5,11,0,134,22,16,3,0,4,14,12,5,5,23,94,106,3,2,0,76,37,124,10,110,2,3,7,0,12,57,7,4,3,1,27,1,77,13,5,1,90,11,0,0,2,0,41,22,2,10,13,3,6,0,27,2,94,11,7,4,2,59,72,5,5,1,1,0,13,118,77,0,10,15,21,5,3,34,20,16,26,8,2,2,8,0,2,2,1,8,2,5,164,5,12,7,21,4,4,33,201,3,0,2,2,0,0,4,1,90,2,19,0,3,1,4,27,1,3,9,13,0,9,6,0,11,83,6,0,588,3,12,17,2,2,12,2,4,0,3,7,11,1,0,7,5,12,1,1,4,7,82,24,30,6,24,0,4,8,1,46,17,98,2,7,3,110,0,141,16,103,0,327,0,0,18,7,7,5,4,8,11,15,62,2,8,0,3,13,1,2,3,1,4,1,15,4,6,2,1,11,2,6,53,80,10,6,1,7,9,61,9,19,3,32,25,0,1724,2,0,2,79,24,9,10,3,8,2,5,4,2,9,50,8,1,11,15,14,31,2,10,0,0,16,1,37,7,7,3,4,78,3,58,9,2,0,23,3,0,2,0,564,0,0,0,285,27,1,105,2,3,3,396,0,30,1,3,0,7,147,2,40,6,16,0,39,1,11,7,0,5,4,17,67,3,3,0,1,12,3,13,3,4,10,0,25,6,22,7,14,3,16,9,16,0,2,50,1,41,18,9,64,48,49,0,10,6,1,1,0,0,4,14,7,13,1,3,2,3,2,61,81,4,18,1,9,38,1,2,104,0,0,8,1,2,14,0,96,1,0,6,96,5,6,3,108,32,0,0,3,19,1,48,23,18,6,176,2,2,59,4,1,0,4,28,4,58,8,15,10,2,2,1,0,15,0,19,23,6,67,2,4,22,7,7,2,25,5,11,10,7,0,2,4,45,1,0,1,2,20,1,35,1,3,6,182,18,15,2,1,2,9,17,3,24,6,0,0,1,1,2,1,33,6,15,84,1,127,1,0,1,85,5,0,0,9,1,1,3,3,8,15,1,0,50,38,6,15,1,9,41,18,0,2,9,0,3,5,4,9,2,1,4,3,14,2,0,0,1,0,48,2,2,11,15,2,0,2,1,14,0,58,0,5,9,0,14,30,1,13,1,9,2,2,3,0,2,1,8,1,7,3,1,8,0,14,2,27,5,1,1,9,1,15,3,8,0,3,5,5,23,2,9,3,0,0,56,1,34,0,51,10,4,1,0,4,1,3,1,0,54,2,14,23,15,3,10,19,2,0,2,1,1,5,2,1,1,10,3,5,1,0,391,2,4,0,2,55,17,7,94,0,3,15,0,1,5,0,0,0,0,20,0,5,12,3,2,438,3,67,3,2,5,454,9,1,0,0,2,1,13,0,2,6,1,3,0,26,9,11,1,8,2,55,2,1,5,1,5,0,6,5,13,6,1,3,1,2,35,2,2,5,1,9,72,2,0,4,2,2,2,322,19,1,0,11,2,6,2,0,16,1,0,11,51,9,1,2,1,6,40,1,453,5,24,0,1,0,182,0,30,3,0,1,5,1,6,6,1,0,2,0,0,5,1,2,0,0,1,1,25,3,6,1,23,0,12,0,14,3,0,1,8,22,0,3,128,6,5,82,6,155,0,4,3,73,1,2,4,0,12,0,7,1,0,0,1,1,2,4,2,1,1,1,0,1,51,41,5,0,1,4,1,0,3,3,1,5,9,2,1,1,10,1,5,1,4,14,23,5,4,0,0,0,8,10,0,0,7,2,0,1,8,1,1,0,1,2,0,0,19,1,4,243,4,1,0,0,12,2,14,4,2,13,8,2,1,8,0,0,1,3,3,17,0,3,8,57,1,13,6,1,1,2,0,1,65,11,25,28,0,1,5,1,0,26,1,0,1,2,16,5,17,0,1,0,0,3,0,2,30,0,29,9,5,3,12,29,1,4,1,6,0,0,2,1,0,0,2,0,0,10,0,38,0,0,7,9,2,42,18,1,6,26,7,6,23,2,25,0,15,13,6,0,2,2,1,0,0,17,44,3,33,13,1,9,3,5,92,0,2,2,0,0,0,5,0,6,0,2,1,0,0,0,12,0,0,41,1,0,0,12,2,4,1,1,1,2,0,0,0,0,39,1,8,4,0,11,0,0,2,2,0,2,15,7,11,1,2,3,0,3,1,1,6,46,0,14,1,0,1,2,0,2,0,11,1,3,4,9,16,0,0,0,1,3,0,0,0,7,6,0,0,0,71,3,3,17,0,1,3,1,5,2,4,10,8,0,50,0,4,18,4,0,0,2,1,3,2,2,0,17,1,0,17,0,0,26,8,1,124,2,0,0,1,0,0,2,0,2,1,40,4,3,1,0,1,2,11,0,1,1,0,27,1,23,2,0,30,0,3,1,9,126,35,0,1,0,3,13,25,6,0,0,4,3,3,3,14,2,1,25,4,17,0,5,5,5,0,0,7,0,2,0,1,1,1,0,0,15,0,1,3,11,0,4,6,18,0,3,0,0,2,4,1,4,3,11,7,1,1,3,2,0,2,0,3,1,0,0,3,0,14,9,0,28,1,0,9,0,6,2,33,5,0,0,0,3,3,1,3,0,2,1,0,0,2,1,2,3,7,5,0,263,2,3,0,79,2642,1,0,86,13,4,8,0,0,0,0,8,10,25,0,15,1,2,22,0,0,1,6,1,0,5,9,1,0,3,8,16,46,30,1,0,2,1,1,4,1,0,3,0,6,0,1,3,2,1,3,1,1,2,5,2,5,9,2,0,10,0,0,1,6,1,3,1,6,1,0,1,6,0,2,0,0,9,2,1,7,2,0,9,0,3,0,1,0,0,0,20,3,2,14,0,3,5,1,4,0,2,1,0,3,0,0,0,1,22,28,0,3,3,1,0,10,10,2,41,1,3,1,1,5,5,0,3,0,0,2,0,0,3,1,1,33,0,0,0,0,7,1,0,0,6,0,8,3,1,0,0,0,2,2,8,0,1,6,0,0,1,2,0,1,0,0,15,3,7,1,0,16,2,0,0,0,0,0,0,0,0,5,12,0,0,0,2,0,0,0,0,0,0,1,5,0,1,8,20,0,2,2,120,4,2,0,0,12,2,0,0,0,9,0,1,42,34,1,1,5,4,2,2,0,17,1,0,5,0,0,1,5,21,0,0,10,3,16,0,0,3,0,5,0,0,1,1,0,1,0,16,0,0,0,0,0,1,0,0,1,0,37,4,2,0,1,0,2,0,22,15,12,1,2,2,2,2,3,0,1,1,3,3,0,9,3,0,7,5,1,1,1,3,0,0,2,0,1,38,40,0,0,0,0,0,1,9,0,7,1,3,3,0,0,29,0,0,1,0,1,4,0,0,17,0,1,0,2,1,0,3,0,0,0,0,0,197,0,0,1,18,2,0,0,0,0,1,3,2,3,1,0,3,2,3,93,10,0,2,0,5,2,25,0,0,0,4,0,1,0,1,0,0,0,24,0,6,0,6,1,0,37,1,0,1,1,1,3,1,0,2,2,0,0,2,0,0,1,5,1,1,9,3,0,0,0,3,3,0,0,0,5,4,16,5,0,2,3,1,0,0,0,1,1,0,1,1,1,0,6,0,0,0,10,0,2,1,1,1,1,21,0,2,0,11,0,1,1,6,0,27,1,2,1,0,0,1,4,0,0,0,0,1,0,0,8,1,0,0,0,2,26,0,0,0,0,0,0,1,16,23,0,8,1,0,8,3,61,2,10,1,0,2,0,0,1,3,0,1,1,1,0,0,0,3,0,4,7,2,7,0,0,0,0,0,9,3,2,1,1,0,4,1,0,2,0,0,2,3,0,0,0,0,0,0,0,0,0,0,2,0,0,1,1,0,1,1,5,0,3,0,2,0,2,2,2,3,0,0,1,1,0,3,0,0,0,1,4,0,25,0,0,0,0,0,0,2,1,1,4,1,0,2,0,1,0,7,0,0,2,0,0,1,1,1,0,0,1,0,0,2,1,1,0,47,2,0,3,0,4,2,5,0,0,1,4,1,0,3,0,16,4,3,1,1,0,1,0,0,4,0,1,1,2,0,4,8,0,2,0,1,2,1,16,0,0,2,0,0,3,0,0,0,0,0,0,3,0,4,0,2,0,0,1,1,2,3,0,0,3,15,1,0,0,0,0,1,0,0,1,0,14,3,4,1,0,1,0,0,3,0,3,0,1,0,2,0,0,2,69,0,0,12,0,2,1,1,0,0,0,1,0,0,18,0,5,1,16,0,0,0,0,0,0,3,2,0,0,0,6,0,0,1,0,0,1,0,2,5,1,5,0,0,2,1,0,1,0,0,0,0,0,0,1,0,0,0,1,0,0,0,1,0,0,1,1,0,0,1,0,0,0,0,0,0,1,1,1,0,0,1,0,0,1,1,0,0,201,0,1,0,0,0,0,0,0,50,0,1,1,0,2,1,0,0,4,1,3,0,0,0,0,0,1,0,1,0,1,1,1,0,3,6,1,0,2,1,0,0,0,0,1,0,0,31,0,0,4,0,1,0,0,7,0,0,46,0,2,4,1,1,0,0,0,8,0,0,0,0,0,50,1,0,0,0,0,0,0,0,1,1,1,4,0,0,0,0,1,2,1,1,0,0,0,0,1,1,0,2,1,1,0,0,2,1,0,0,0,0,0,1,0,2,0,0,0,0,0,0,0,0,0,1,2,26,2,0,0,5,4,8,0,0,0,1,0,1,11,0,0,0,1,0,0,0,0,0,0,0,3,0,1,0,0,2,0,0,0,4,0,0,0,0,1,0,1,9,0,4,0,0,0,1,0,0,0,0,2,1,1,0,1,0,0,0,0,3,0,13,1,1,1,0,0,22,0,2,1,0,0,1,3,0,0,0,1,0,0,0,1,0,1,0,2,1,0,1,0,2,0,0,2,0,0,0,0,7,0,0,3,0,0,0,0,0,1,0,0,2,0,3,0,0,9,1,0,0,0,0,0,3,1,1,0,4,4,0,0,0,1,1,0,0,1,2,0,0,0,0,6,0,0,4,4,1,2,0,0,0,0,0,0,0,0,1,5,0,0,0,0,0,0,0,1,0,0,0,0,13,0,0,1,1,0,0,0,2,0,0,0,0,0,0,1,0,22,0,0,0,0,1,2,2,0,0,12,0,0,4,0,2,1,0,3,0,0,1,0,0,1,0,0,4,4,2,0,0,1,0,0,0,0,3,1,2,0,3,0,0,0,4,0,0,1,0,0,0,0,1,0,1,1,0,0,1,0,0,0,0,3,0,0,0,0,0,0,0,0,0,0,1,0,2,0,0,0,1,0,0,0,1,7,1,0,0,0,0,2,0,15,0,2,2,1,1,1,0,0,1,0,0,0,1,0,0,0,0,0,0,1,4,0,4,1,20,1,0,1,0,1,0,0,0,0,0,0,0,0,0,1,0,4,1,0,0,1,0,1,0,0,2,3,0,0,1,0,1,0,0,0,15,0,0,0,0,0,16,0,1,0,0,0,0,0,0,1,0,0,0,0,1,0,0,0,0,0,0,11,0,0,1,0,0,0,0,0,4,0,0,0,0,3,0,0,0,0,2,1,1,0,0,0,0,0,1,0,0,0,0,0,0,0,1,4,0,0,0,1,0,1,0,0,0,0,1,1,0,0,0,0,0,5,0,0,0,0,0,0,0,1,0,0,0,8,0,0,0,4,0,0,0,0,0,2,1,0,0,0,1,1,0,0,0,6,0,0,4,11,0,1,0,0,2,0,1,0,1,0,0,1,0,0,0,0,0,0,0,0,0,0,0,0,0,0,1,0,0,0,0,0,0,0,0,1,0,0,0,0,0,1,0,1,11,0,2,0,0,0,0,0,0,0,0,0,1,0,0,0,0,0,0,0,0,0,0,1,0,3,0,0,0,0,0,1,0,0,0,1,0,1,1,0,0,0,0,0,0,0,0,1,0,0,0,0,0,0,0,1,0,0,0,0,0,0,0,0,4,0,0,0,0,1,0,0,0,0,0,0,0,0,0,0,1,0,1,0,0,1,0,0,0,1,0,0,0,0,0,0,1,0,72,2,0,0,1,0,0,0,0,1,2,2,0,0,0,0,0,2,0,0,0,0,0,0,0,0,0,0,0,10,0,0,0,0,1,0,0,0,0,0,0,1,0,1,0,0,0,0,0,0,0,8,1,0,0,0,0,1,0,0,1,0,0,0,0,0,0,1,0,0,0,0,0,1,0,0,0,0,0,1,0,3,0,0,0,2,0,0,0,0,0,0,0,0,0,0,0,0,0,0,0,0,0,0,0,0,0,0,1,0,0,0,0,0,0,5,4,0,0,0,0,0,0,0,0,0,0,1,0,1,11,0,0,0,0,0,0,0,0,1,0,0,0,0,0,0,0,0,0,0,0,0,0,0,0,0,0,0,0,0,0,0,0,0,0,2,0,0,0,1,0,0,0,1,0,0,1,0,1,0,0,0,0,0,0,0,0,0,0,0,0,0,0,0,0,0,0,0,0,0,0,0,0,0,0,0,0,0,0,0,0,0,0,0,0,1,0,0,0,0,0,0,0,0,0,0,0,1,0,0,0,0,0,0,1,0,0,0,0,0,0,0,0,0,0,0,0,0,0,0,0,0,0,0,0,0,0,0,0,0,0,0,0,0,0,0,0,0,0,0,0,0,0,0,0,0,0,0,0,0,0
"Rectal Cancer",784,330,312,14023,129,2390,124,84,617,307,96,630,106,164,134,88,1247,393,119,185,195,116,7815,316,29,27,265,2679,246,41,398,625,69,63,103,236,144,23,593,37,1437,1199,218,84,61,147,7,12,93,577,16,26,20,511,90,33,63,141,422,387,1458,142,179,72,8801,283,280,108,6,140,119,26,56,44,275,153,3,319,101,1482,105,625,3726,807,941,14,593,55,2,81,56,1152,1938,13,87,20,94,65,6,1544,48,183,1028,3,19,54,279,39,28,3887,48,22,28,75,553,9,31,48,33,29,30,13,12,191,39,128,2118,237,87,1857,42,402,355,42,69,827,36,17,68,151,11,88,38,122,373,851,25,111,10,30,386,28,225,116,76,35,140,127,212,32,5,15,11,7,6,15,261,42,20,71,454,9,22,80,55,17,31,66,47,15,9,2280,569,3,26,126,47,20,6,40,82,15,13,28,11,41,45,118,16,199,1,1,55,3,2,200,133,221,2,725,27,17,1055,51,22,95,1410,4,18,9,1393,21,8,14,12,19,22,125,730,1360,72,173,47,0,24,73,16,1061,18,7,15,0,1177,51,9,109,6,13,47,9,51,20,63,16,113,56,8,127,16,34,49,3,17,144,4120,576,361,267,51,45,86,43,15,4,2,0,630,7,0,116,41,39,11,52,5,8,30,1,2,18,11,0,112,38,28,305,15,5,113,11,8,32,101,283,0,288,11,3,326,9,6,5,106,14,434,32,6,3,193,0,31,5,51,26,25,35,84,36,2,2,96,61,65,2,66,4,2,2,0,20,108,36,8,261,43,3,21,27,4,10,23,2,13,4,9,13,60,31,3,6,6,9,11,2,240,48,1,48,2,2,5,465,15,540,4,21,7,3,13,2,13,20,24,14,20,6,12,59,509,36,13,622,0,4,3,36,58,2,377,60,1095,27,5,2,83,2,18,46,158,4,1,3,12,218,16,7,0,38,580,3,33,29,25,37,0,7,6,2,6,14,1,48,609,8,8,6,3,6,3,16,6,0,3,9,3,30,8,94,2,3,8,345,61,47,3,0,0,4,35,5,47,8,2,461,2,41,313,1,1,11,8,42,6,9,170,41,26,116,18,2,2,101,5,118,7,1,23,100,31,1,188,11,108,6,133,3,21,23,7,11,3,1,54,1,8,7,202,0,40,6,7,283,67,4,2,10,10,19,9,10,7,53,31,14,9,967,4,7,0,6,2,57,442,119,28,5,36,5,14,28,387,18,57,0,29,17,10,22,16,41,3,10,5,1,116,233,19,18,15,156,40,6,30,25,0,11,7,6,6,1,38,2,61,30,7,14,453,3,1,0,2,2,65,10,7,7,183,0,0,2,23,4,7,12,12,3,11,6,11,29,2,1,41,16,36,3,17,8,30,2,20,43,0,6,0,39,38,11,4,56,117,68,98,53,5,7,1,12,0,7,191,0,350,10,24,4,1,14,33,11,160,7,8,13,60,217,4,1,30,31,39,6,1,4,2,1162,2,4,20,0,2,300,3,3,6,54,0,7,24,518,14,3,6,5,68,0,120,1,64,9,18,21,2804,36,140,5,8,63,42,10,43,75,122,0,7,1,2,2,2,42,114,5,4,2,0,11,12,0,5,2,16,4,453,51,10,28,42,1,0,32,11,17,43,58,34,11,9,0,0,1,8,40,73,1,4,90,14,4,0,46,11,11,1,47,1,2,21,2,4,1,2752,8,884,8,3,188,0,2,7,8,4,52,1,156,5,434,85,170,298,22,6,1,0,0,14,7,126,3,1099,11,1,87,4,2,10,5,2,1,5,48,3,3,116,4,13,0,1,2,4,18,2,5,0,12,6,5,0,2,1,33,62,9,12,0,23,1,4,30,3,9,3,1,7,3,0,702,11,3,0,1,1,58,3,6,7,146,96,28,1,1,9,0,2,34,2,6,2,0,0,1,1155,19,1,10,5,57,1,36,0,1,0,30,11,8,44,3,1,8,6,35,1,48,0,14,1,18,42,4,0,5,1,4,35,4,3,0,2,1,0,2,318,1,15,11,33,313,11,32,2,116,0,4,5,1,2,1,6,8,19,0,1,0,2,70,22,7,14,2,46,11,0,2,511,1,1,2,5,1,19,38,0,10,16,0,30,0,8,2,4,5,2,127,19,1152,0,6,34,1,79,0,59,0,207,18,3,1,8,1,1,1249,16,3,5,984,21,0,408,1,4,10,0,5,6,11,0,6,43,19,14,2,2,9,0,15,1,99,8,1,24,4,8,7,488,3,10,2,3,0,4,1,6,4,47,7,1,4,39,3,0,0,5,4,0,93,0,9,2,3,7,2,16,9,3,12,2,65,13,16,3,1,0,6,5,12,0,48,22,43,0,0,0,16,1,5,3,13,3,4,11,4,9,0,0,3,1,0,14,1,33,18,0,0,26,1,0,6,0,0,42,25,3,2,21,1,2,0,112,20,654,2,6,4,0,35,13,1,1,0,0,0,2,28,57,1,3,2,2,3,5,1,335,9,1,1,1,6,12,0,23,1,0,4,1,5,14,7,6,4,12,2,1,12,54,1,0,0,7,1,0,1,0,43,3,13,0,2,0,2,8,0,1,6,137,3,1,1,0,0,8,1,0,242,7,5,11,0,10,13,0,1,3,4,9,1,0,2,0,28,4,1,1,0,1,71,2,10,2,2,101,6,11,0,40,5,1543,0,12,0,41,1,5,0,28,0,1901,0,0,25,13,0,1,0,5,33,9,24,0,3,2,1,12,2,19,1,0,1,7,8,0,7,0,0,30,1,1,11,38,4,12,1,33,1,4,12,5,1,34,3,0,222,0,0,4,116,2,9,2,0,55,0,27,3,0,3,35,2,1,8,6,37,4,0,6,0,2,11,0,13,25,5,0,1,6,0,5,0,17,0,4,2,3,0,1,97,1,34,0,74,7,1,34,8,0,18,533,0,5,3,2,4,5,35,2,3,4,1,1,6,4,3,10,0,1,6,38,11,0,0,0,0,25,0,1,0,30,34,0,2,2,15,2,29,2,10,7,23,1,0,8,0,3,60,20,3,585,9,0,6,2,2,4,0,2,1,4,3,4,1,3,0,17,0,18,3,11,6,4,13,12,1,1,14,0,0,1,2,3,4,0,0,0,1,2,12,2,28,0,52,21,1,3,3,38,10,14,5,5,4,23,3,2,14,3,6,0,0,2,2,0,5,8,8,1,1,5,0,1,0,4,27,3,38,3,4,26,2,0,1,306,1,7,1,1,2,0,2,18,0,1,0,5,4,0,2,1,3,11,229,1,3,1,1,0,1,76,3,1,4,0,3,0,2,0,0,9,3,2,19,0,39,7,0,0,25,0,5,1,4,0,1,2,3,4,5,16,4,5,1,1,34,5,23,8,406,0,4,5,0,0,2,47,2,4,0,0,0,3,2,0,0,1,0,32,0,0,8,13,11,2,0,0,590,2,19,0,0,6,0,6,17,1,8,0,2,0,0,5,3,5,0,6,0,1,1,0,3,1,73,0,16,1,1,0,3,2,7,1,5,0,35,1,0,119,0,35,6,0,0,12,38,4,0,47,44,1,0,1,1,0,14,5,1,15,3,4,8,0,0,0,6,0,4,7,0,0,1,3,0,3,20,1,17,4,0,11,5,2,9,3,22,3,28,11,3,53,173,0,0,2,1,0,0,0,8,0,4,37,0,1,33,1,10,1,0,0,186,4,0,0,0,0,0,2,0,1,229,1,0,0,12,10,5,0,0,0,66,0,0,6,3,10,0,34,238,14,4,25,96,1,1,29,1,3,2,13,2,32,0,0,66,4,0,0,3,6,0,1,2,6,2,1,0,0,1,0,9,1,534,0,2,1,8,1,7,806,2,2,0,0,0,16,1,77,1,0,1,2,0,18,0,0,1,8,0,2,3,0,1,1,1,0,1,27,2,1,0,50,1,3,0,2,18,0,0,3,1,0,1,264,7,2,11,0,192,0,0,5,13,1,1,2,1,1,0,7,0,0,2,2,1,0,1,1,0,0,39,0,0,17,16,1,0,0,1,0,0,3,0,2,1,0,0,1,0,9,0,0,0,0,7,7,5,1,0,0,0,4,3,0,0,2,14,1,1,3,0,0,0,6,1,0,0,1,0,0,47,0,2,0,0,2,4,7,0,0,0,4,1,1,14,0,0,0,29,0,29,2,5,1,9,0,3,5,0,0,2,0,0,69,22,78,21,2,0,2,1,1,21,0,0,1,1,9,6,16,0,2,0,0,1,0,0,3,0,7,2,1,19,8,16,0,0,0,161,0,0,0,0,4,0,0,1,1,1,1,9,0,1,9,1,0,37,0,2,0,3,5,3,0,2,24,2,5,1,5,0,3,3,0,2,2,3,25,13,7,0,1,0,7,3,21,4,0,1,0,0,0,6,0,4,0,0,4,0,1,0,2,0,0,1,13,0,2,8,6,2,0,0,4,2,0,0,0,0,17,0,0,1,0,2,1,0,0,0,0,1,6,0,12,0,2,5,0,0,1,0,1,9,0,5,2,0,0,0,4,0,0,5,1,0,2,8,3,0,0,1,3,2,0,0,3,21,1,0,0,0,12,0,39,1,0,1,0,0,5,0,1,0,1,0,59,0,1,2,3,0,0,0,0,2,0,0,0,9,0,0,1,1,0,62,1,0,22,5,0,0,0,2,0,0,0,6,0,33,1,0,0,2,1,0,3,0,0,0,0,5,1,2,1,0,4,0,0,2,4,42,21,0,0,1,5,68,30,1,0,2,16,0,2,0,29,0,0,5,1,12,0,0,3,6,0,2,21,2,0,0,0,0,31,3,0,1,0,1,2,18,1,4,2,4,0,0,1,0,0,2,1,2,1,10,7,1,0,2,2,0,0,0,6,0,1,0,0,0,9,2,0,55,1,2,168,0,0,12,11,5,5,0,0,0,1,0,9,0,0,1,0,1,2,1,10,3,2,1,1,12,0,2,0,1,191,0,0,13,9,0,112,0,2,0,0,2,5,5,0,1,3,0,0,0,0,1,2,0,0,5,0,9,0,0,3,2,12,711,0,0,0,0,1,0,1,0,4,0,1,0,0,0,0,1,0,1,0,21,80,0,4,49,0,0,3,2,0,0,0,3,0,0,23,5,0,0,61,0,0,0,0,12,0,0,6,0,1,22,1,0,0,1,0,0,0,5,5,0,2,0,0,1,1,0,2,9,21,1,1,3,0,0,0,6,3,0,3,0,1,1,9,7,2,11,0,0,1,0,2,1,0,4,6,0,0,0,0,173,0,0,12,1,0,0,0,111,2,1,0,9,0,287,0,0,2,0,0,1,1,3,0,0,3,0,0,0,2,1,1,0,3,8,1,6,0,0,0,1,3,0,0,1,0,0,1,0,12,2,29,0,1,2,0,7,0,0,0,4,1,2,0,0,0,10,0,1,0,2,0,0,5,0,10,0,0,0,1,8,0,0,271,13,0,1,0,0,0,1,0,2,1,0,45,3,0,0,0,9,1,0,72,0,20,0,0,3,3,0,1,0,0,0,0,5,0,5,0,0,2,0,0,0,0,2,1,0,5,1,46,0,0,7,9,1,1,2,2,0,2,0,3,0,0,3,1,1,2,0,1,3,0,0,1,0,0,0,0,3,0,0,0,0,3,13,2,0,1,0,0,0,2,7,0,5,1,9,2,0,0,15,0,0,0,0,0,16,3,0,6,0,29,0,1,0,0,7,0,0,0,0,1,22,0,0,0,14,1,1,1,0,0,0,1,1,1,0,0,5,4,4,48,3,0,4,0,46,0,93,0,0,0,11,0,0,0,0,0,0,0,4,1,0,4,4,0,0,8,0,0,0,0,1,0,1,1,0,5,0,0,2,0,0,0,8,1,1,33,8,1,0,0,0,1,0,0,0,5,7,7,5,0,0,1,0,0,0,0,1,0,0,8,0,2,0,1,1,0,0,2,0,1,0,0,0,0,4,0,0,0,58,0,0,0,4,0,0,0,1,0,1,0,2,2,0,0,0,0,0,1,3,11,0,5,0,0,1,10,1,0,1,0,0,0,1,0,9,0,3,16,0,2,0,17,0,1,0,0,0,4,3,0,4,0,0,0,0,0,0,0,1,0,1,1,4,3,0,0,0,0,1,0,0,2,0,0,0,1,0,0,1,1,0,0,0,2,0,0,0,1,0,0,0,0,0,0,13,0,1,0,0,0,0,1,0,27,0,0,0,5,0,0,0,0,0,1,0,0,4,0,0,0,0,0,0,9,9,0,2,0,0,0,0,11,5,0,0,0,5,0,1,0,2,0,1,0,0,0,0,0,0,0,0,0,0,3,1,0,0,4,4,0,0,10,0,0,1,0,1,0,0,0,0,2,3,0,2,0,3,1,0,0,0,0,0,2,0,0,0,0,0,0,0,0,0,0,3,0,3,1,0,0,1,0,3,10,0,0,0,0,0,0,0,0,26,0,1,0,0,1,0,6,2,0,0,4,46,0,0,1,0,0,0,0,0,0,0,0,0,5,0,0,0,21,0,9,0,1,0,1,0,11,1,0,0,6,0,0,3,0,1,0,1,0,0,2,0,0,0,0,0,5,0,0,0,0,0,0,0,1,0,0,1,0,0,0,0,0,2,0,0,0,0,0,2,1,2,0,0,71,0,1,1,0,0,2,3,0,0,1,0,0,0,1,0,0,0,0,0,0,3,3,0,0,0,0,0,1,0,0,0,0,0,2,1,0,1,0,1,2,2,0,1,41,0,1,0,21,0,0,0,1,9,0,6,0,0,0,0,0,0,0,0,2,2,0,0,0,0,0,2,0,1,0,0,0,0,1,32,1,0,2,0,0,0,1,1,0,0,0,17,0,0,15,1,1,1,1,0,0,0,30,0,0,0,0,0,0,0,0,11,0,0,0,0,0,7,1,0,0,0,0,0,0,0,0,3,1,3,0,0,0,0,0,2,0,3,1,0,0,0,0,5,0,0,0,0,2,0,1,0,0,0,0,0,0,0,7,0,0,0,0,0,1,0,0,1,0,0,0,1,4,0,0,14,1,2,0,0,0,0,7,0,13,0,0,0,1,0,0,1,0,1,0,1,4,3,0,1,0,0,0,0,0,0,0,0,0,0,0,0,0,0,0,2,0,0,0,0,0,0,7,0,2,3,0,2,0,0,0,0,0,3,1,3,0,0,0,0,1,15,0,0,3,0,0,0,1,0,1,1,1,0,0,0,0,0,1,1,6,3,0,0,0,0,0,2,0,0,0,1,0,0,0,1,1,0,0,3,1,0,0,0,0,0,0,0,0,0,2,1,0,2,0,0,0,5,0,0,1,0,0,5,1,0,0,0,0,0,0,3,0,1,1,0,1,0,0,1,1,9,0,0,0,0,0,0,0,1,0,1,4,0,0,0,0,0,0,0,0,0,0,2,0,19,5,0,3,0,1,0,0,0,0,0,2,0,0,0,1,1,1,0,0,0,0,0,1,1,0,0,2,0,0,0,0,12,1,0,3,0,0,0,0,4,0,0,0,6,3,1,48,0,1,1,2,0,0,0,0,0,2,0,0,2,0,8,0,0,11,0,0,1,0,0,0,0,0,0,0,0,0,0,0,0,0,0,0,0,0,0,0,0,0,0,0,0,0,3,0,0,0,0,0,0,0,0,0,0,0,1,0,0,0,0,79,1,1,3,0,0,0,0,1,3,0,0,10,1,0,0,0,0,0,0,0,4,0,6,0,1,5,0,0,0,3,0,0,0,1,0,0,0,0,0,1,0,3,7,0,0,1,0,0,0,0,1,0,0,0,0,0,0,0,0,0,1,0,0,0,0,0,3,0,0,0,0,0,0,0,0,0,0,1,1,0,0,0,0,0,0,0,0,12,0,1,0,0,0,0,0,0,1,0,0,1,0,5,0,0,0,0,0,0,0,0,2,1,0,4,0,0,0,0,0,0,0,0,0,0,0,0,0,4,0,0,0,0,0,0,0,0,1,0,1,0,0,2,0,0,0,0,0,0,0,0,0,0,0,4,0,0,3,9,0,1,0,0,0,0,2,0,0,0,2,0,0,0,0,2,0,25,0,2,0,7,0,0,0,0,3,0,1,0,0,0,2,0,0,0,1,0,0,0,0,0,0,4,0,0,0,0,0,0,0,0,0,0,1,0,0,0,0,0,5,0,0,0,0,0,2,0,0,0,0,0,0,0,0,0,1,0,0,0,1,0,0,0,0,0,0,0,2,4,0,0,0,0,0,0,0,0,0,3,0,0,0,0,1,0,0,0,0,0,0,0,0,0,0,0,0,1,0,2,0,0,1,0,0,0,0,0,3,2,1,0,0,1,0,0,0,0,0,0,0,0,0,1,0,0,0,0,0,0,0,0,0,0,0,0,0,0,0,0,0,0,33,0,2,0,0,0,0,0,0,0,0,0,0,0,0,0,0,1,1,2,1,1,0,0,0,0,0,0,0,4,0,0,0,0,1,0,0,0,0,0,0,0,0,1,0,0,0,0,1,0,1,2,0,0,0,0,0,0,0,0,0,0,0,0,0,0,0,83,0,1,0,0,0,0,0,0,0,0,0,1,0,0,0,2,0,0,0,0,0,0,0,0,0,0,0,0,0,0,0,0,0,0,0,0,0,0,0,0,0,0,0,1,0,0,0,0,0,0,0,0,0,0,0,0,2,0,0,0,0,0,0,0,1,0,1,0,0,0,0,2,0,0,0,1,0,0,0,0,0,0,0,0,0,0,0,0,3,1,0,0,0,0,0,0,0,0,0,0,0,0,0,0,0,2,0,0,0,0,0,0,0,0,0,0,0,0,0,0,0,0,0,0,0,0,0,0,0,0,0,0,0,0,0,0,0,0,0,0,0,0,0,0,0,0,0,0,0,0,0,0,0,0,0,0,0,0,0,3,0,0,0,1,0,0,0,0,0,0,0,0,0,0,0,0,0,0,0,0,0,0,0,0,0,0,0,0,0,2,1,0,0,0,0,0,0,0,0,0,0,0,0,0,0,0,0,0,0,0,0,0,0
"Sarcoma",5923,308,750,18638,219,2657,765,204,230,1254,779,1137,138,383,199,662,14992,141,1049,823,919,157,14157,129,370,123,846,439,979,162,1298,1504,351,211,287,962,316,92,510,94,8577,194159,1103,39,985,1106,52,171,801,655,64,101,87,1311,370,314,373,309,939,1677,7033,493,280,144,10034,341,1901,429,86,270,262,184,166,1030,550,470,41,656,229,662,3516,2069,2168,587,1292,51,7495,170,41,306,456,4222,413,74,2003,151,274,160,195,932,428,746,1428,87,182,35,445,369,53,2517,191,60,274,81,313,155,127,253,148,125,335,25,30,1040,51,392,3479,4558,657,176,28,723,4840,211,1345,531,288,92,2088,179,25,322,143,225,408,441,38,499,18,176,6850,95,1179,318,316,111,732,802,317,210,29,122,69,25,62,172,1711,141,176,118,691,41,245,118,129,184,259,140,481,86,65,1424,1307,24,27,550,95,35,26,129,1017,150,87,242,57,329,542,115,701,231,17,36,62,38,16,118,600,1581,26,1455,333,176,16386,757,94,943,404,66,58,63,407,52,31,73,59,68,147,1298,320,85,222,740,96,24,65,285,225,915,314,44,45,19,293,765,20,1024,79,95,1010,81,198,193,82,14,323,721,50,204,114,229,367,29,97,1921,471,79,736,2186,535,88,238,876,29,69,14,41,55,78,13,709,2561,154,55,236,49,18,2140,110,9,117,32,51,633,64,45,154,84,10,209,54,32,74,56,2628,15,2666,82,36,137,73,132,31,33935,162,1239,84,178,12,710,18,40,42,80,580,102,797,56,46,9,10,148,43,135,17,141,393,39,108,11,3080,385,290,125,135,299,13,86,116,108,164,90,45,32,92,41,9,60,109,31,15,32,52,551,11,67,798,6,66,14,6,64,1296,30,69,32,578,204,24,132,5,169,131,73,122,92,39,360,52,12,62,64,120,6,486,15,76,66,84,413,61,63,94,991,22,400,74,48,153,2989,37,59,65,108,899,45,58,15,45,439,47,114,170,289,47,58,37,45,3,74,62,17,137,109,72,55,113,77,20,26,32,117,7,10,28,11,50,60,49,16,3,17,473,505,179,56,4,17,10,109,27,178,37,13,14,19,337,414,16,50,53,146,87,43,80,1072,118,24,71,49,25,41,88,127,294,425,5,23,246,1013,17,1084,132,29,50,982,12,27,404,30,82,48,16,212,7,36,41,574,46,510,42,244,2197,25,64,43,259,56,1960,31,54,31,26,31,61,12,919,18,29,4,34,3,132,689,302,37,43,75,98,42,1216,479,47,3590,32,253,155,143,91,40,184,51,20,25,24,618,128,26,14,792,1033,258,52,87,34,9,203,45,35,53,79,36,16,254,92,17,90,202,4,20,9,39,5,40,71,133,33,74,38,6,147,338,43,91,65,136,16,184,71,62,89,11,10,21792,27,179,29,72,31,53,18,128,47,4,75,10,1286,48,94,17,30,1991,51,165,374,98,30,22,29,4,53,433,99,608,20,26,41,11,84,34,71,267,36,32,96,892,102,46,88,51,69,26,41,12,5,17,49,11,11,27,3,32,48,47,23,54,107,5,25,374,137,239,28,32,18,249,6,64,22,68,98,36,104,119,186,488,45,35,15469,37,27,411,1392,137,5,136,32,20,14,35,720,143,7,35,10,12,100,566,55,11,13,29,1,115,10,86,196,28,1,53,29,21,75,3,3,134,40,39,27,36,27,117,5,47,36,8,53,155,11,11,107,18,37,107,38,13,65,231,133,14,18,62,11,398,45,4,1545,12,261,44,131,40,296,10,126,58,75,41,29,29,55,40,28,7,23,389,72,37,50,302,29,11,13140,2,77,19,36,9,7,24,116,9,14,2256,61,30,29,30,2,22,19,41,38,9,37,17,52,13,54,15,106,22,66,66,2,15,3,8,96,8,25,20,51,37,22,12,151,11,38,0,113,9,24,7,26,39,536,40,299,11,3,253,0,33,1699,0,17,11,11,1,28,21,57,16,13,32,75,3,189,2,25,5,135,371,73,382,18,9,38,131,37,8,513,1,23,11,107,176,42,10,38,3,4,436,31,8,24,5,5,0,13,11075,39,548,127,140,42,95,72,223,12732,8,34,22,6,6,14,38,132,31,23,10,5,19,26,43,60,95,13,342,659,20,13,207,27,19,9,495,4,344,407,41,1367,48,2,174,0,5,3,7,38,51,253,111,1375,0,9,115,9,187,14,20,4,167,13,19,7,24,1,7,57,32,9,145,68,417,1,123,5,164,35,29,113,13,28,2,10,485,125,114,7,1,4,53,28,19,96,52,2,123,14,47,14,28,6,17,18,26,4,24,22,190,172,591,31,6,54,219,10,20,4,29,136,2,28,25,126,4,14,29,10,56,18,6,13,6,28,46,76,5,7,16,54,15,19,7,383,10,110,1,3,3,0,15,12,38,551,17,21,26,3,46,26,14,73,5,2,32,2,8568,7,4,7,188,10,9,15,2,4,47,90,6,21,698,2,9,5,68,19,80,9,23,38,8,224,7,12,4,3,0,13,31,9988,152,0,9,65,220,6,27,168,19,28,10,10,3,41,50,26,17,17,1,9,3,28,322,32,21,7,6,26,14,134,192,44,6,7,350,2,0,17,20,274,8,140,2,1,0,0,18,0,1,26,249,12,11,4,13,19,195,10,0,202,28,24,7,3,33,44,5,18,2,81,7,24,2,9,58,403,43,4,8,0,17,58,6,9,11,54,8,12,3,0,3579,66,11,6,49,50,89,0,0,16,328,0,24,0,0,65,13,6,10,44,10,5,25,11,3,4,0,7,12,34,20,6,0,11,4,120,32,18,55,15,53,17,11,386,6901,43,25,15,45,27,161,17,169,23,39,83,7,19,8,3,72,173,822,2194,26,4,30,10,17,32,20,47,7731,24,12,23,24,58,5,3,91,2,8,36,5,85,54,76,10,2,17,55,18,1,20,3,22,73,1,3,9,8,5,18,4,363,75,10,89,10,1,6,442,1,8,12,16,221,7,6662,1,5,16,49,6,2,19,14,176,4,9,29,564,65,2,2,7,6,22,4,56,3,36,344,7,80,21,367,69,277,6,49,15,79,0,10,72,50,16,39,31,47,18,138,2,29,21,84,41,3,8,14,17,30,51,11,38,7,18,0,114,9,15,17,27,372,53,2,8,502,4,4,13,12,20,210,20,29,14,0,36,63,6,52,33,306,47,2,3,5,161,15,164,33,4,46,184,6,7,5,10,7,0,16,8,8,96,36,29,9,4,3,8,1,23,1,71,372,38,36,11,10,1738,44,53,13,17,9,15,41,59,1,2,22,93,11,3,1,1,21,4,10,0,15,96,19,20,54,6,12,4,6259,140,22,513,30,3,8,5,0,1,2,29,6,64,272,15,6188,104,3,1,280,0,20,1,63,21,31,110,102,127,104,1,8,42,8,3,19,17,75,66,22,4,7,6,3,11,0,4,102,30,3,0,16,57,14,2,6,6,0,7,1,12,220,4,2,7,12,7,55,17,147,0,1,258,4,97,17,5,11,3,21,1,2,3,2,5,6,35,5,7,11,2,13,1,13,10,98,12,0,5,6,31,82,1,67,0,5,6,0,23,7,20,1,3,5,83,5,28,9,317,16,3,5,5,62,2,16,12,3,5507,11,19,158,0,10,0,165,9,6,27,16,17,8,21,1,2,41,0,110,34,1,58,4,14,5,8,54,165,78,428,14,35,122,13,1,10,9,22,1,15,45,18,17,46,7,2,18,25,337,207,7,21,115,35,0,5,6,1,1,3,9,4,7,7,2,1,962,42,177,8,1,15,899,2,6,9,209,16,5,33,4,1340,2,55,51,3,9,2856,28,20,17,7,11,912,22,1,13,8,1,0,6,135,2,13,71,18,21,4,0,9,9,22,111,12,8,5,25,7,14,7,14,27,69,7,2,5,2,14,22,74,3,7,18,21,4,192,15,0,10,8,0,11,56,2,6,13,12,2,5,226,1,11,14,31,2,32,3,9,14,1,0,35,139,0,6,56,167,7,147,3,214,3,5,1,0,3,7,18,13,5,3,1048,0,1,25,5,23,29,35,10,0,3,3,0,0,1,246,1,3,5,11,14,0,73,0,62,5,8,27,10,5,183,33,2,14,17,295,32,42,475,3,13,2,14,124,0,2,19,8,3,3,22,0,14,2,3,3,8,2,11,6,3,3,7,1,0,0,3,2,12,7,0,21,179,3,2,22,7,0,1,69,4,707,6,17,2,149,1,12,27,4,10,3,6,1,102,98,1061,33,141,1055,9,54,0,160,3,8,9,16,55,33,65,1,18,16,4,14,11,7,291,2,60,1,12,6,39,523,1,11,0,5,0,0,1,1,2,1,0,5,13,38,3,149,2,5,14,16,16,372,19,10,3,138,22,6,22,2,39,2,3690,8,563,0,9,43,6,4,0,7,65,3,79,44,36,153,2,131,14,1,2,11,0,0,10,78,1,55,2,1,55,0,5,0,370,0,17,1,23,2,5,29,2,22,2,3,13,27,4,55,21,0,3471,0,5,5,13,18,3,1,14,2,2,4,13,1,190,12,5,6,12,8,11,6,10,10,0,6,5,0,15,8,9,0,23,22,4,2,12,27,23,0,19,1,53,3,8,1,128,152,53,0,0,2,10,0,3,13,4,5,8,6,21,11,6,10,1,2,355,3,2,102,1,22,1,2,5,3,2,2,0,700,5,0,5,1,2,1,60,3,2805,9,4,2,1,4,1,8,9,46,5,80,54,7,1,5,0,4,10,0,3,3,26,10,101,11,4,1,17,0,3,1,5,61,50,0,7,0,2,10,107,5,6,1,4,16,20,19,16,2,1,147,8,13,0,1,50,17,12,3,39,2,5,2,3,3,50,4,1,2882,1,23,3,130,6,22,3,9,1,14,0,1,5,18,3,2,7,6,83,3,0,68,4,1,3,4,8,8,7,0,16,2,62,14,0,92,2,9,52,4,33,0,118,8,4,1,2,95,37,3,11,2,0,4,2,1,17,7,19,11,79,4,0,55,9,4,0,4,6,3,0,2152,70,0,25,1,2,39,18,11,409,71,8,3,11,243,0,1,1,21,16,3,2,4,7,8,4,1,4,8,2,9,0,5,1,0,13,3,2,28,8,1,39,1,4,1,2,1,0,0,15,2,6,1,11,31,4,12,3,4,1,10,7,4,6,8,321,7,12,12,5,2,3,5,4,50,4,1,8,2,3,22,8,2,1,5,3,0,0,26,2027,26,26,12,10,398,0,5,2,20,7,0,20,61,0,1,0,287,14,0,9,2,5,4,2381,32,88,47,6,4,1,1,18,7,1,173,9,1,2,12,0,6,6,12,2343,5,0,7,0,30,12,8,0,2331,2,4,33,0,1,2,1,3,4,5,2,6,118,1,0,18,3,1,2,6,5,115,11,57,0,3,9,217,12,1,4,1,0,1,2,2,129,7,7,0,2,11,0,2,0,2,0,5,2,5,0,0,36,30,0,3,10,5,9,1,87,5,16,171,0,0,115,3,1,1,46,1995,13,5,0,7,1,18,1,0,33,0,77,11,1,4,28,765,48,4,29,25,24,0,1,4,7,4,2,1,1,1,0,24,4,36,0,11,5,0,0,1,0,11,0,1,14,883,15,1,0,31,8,0,32,44,24,3,39,8,5,1,68,0,9,2,46,6,10,1062,11,0,55,284,3,2,5,14,1,0,1,0,2,53,25,5,2,5,1,1,5,9,11,66,11,3,42,3,2,34,0,11,6,3,133,21,3,11,9,0,34,0,3,2,4,11,6,2,5,1,8,20,0,1,2,8,23,3,1,0,1,0,38,4,2,69,0,10,26,6,28,6,10,8,3,0,0,66,1,0,7,31,2,11,2,1,2,10,0,42,4,38,2,426,0,4,11,0,3,14,1,2,7,1,0,2,0,4,1,6,1,1,0,12,0,5,29,3,0,1,0,0,164,0,1,0,1480,7,80,205,1,31,6,2,4,1,0,13,1,1,6,6,7,1,2,10,3,1,7,0,7,2,0,0,3,3,3,6,0,2,0,2,0,1670,0,2,15,23,33,143,0,48,10,1,2,9,3,1,8,10,1618,131,4,10,23,0,295,0,9,22,0,1,5,2,1,17,4,1,1,0,4,92,154,0,2,2,0,60,1,20,0,0,2,1,8,0,5,7,3,9,1,10,5,7,0,2,0,2,0,33,10,1,4,145,420,0,1,143,7,0,4,1,2,2,4,1,2,1,2,0,0,0,1,7,1,24,10,8,40,1,0,2,3,1,1,0,1,0,10,2,1,13,0,4,1,1,4,1,0,2,3,17,1,3,27,8,1,13,1,0,0,1,34,22,7,4,3,69,9,1,9,308,4,1,1,0,1,0,1,0,0,14,1,0,0,3,0,4,0,0,46,0,5,0,4,7,4,2,0,2,2,1,2,13,0,1,6,3,11,0,3,131,1,23,10,3,28,0,3,2,1,99,0,0,0,7,2,8,36,0,0,6,1,1,3,3,1,0,1,2,0,15,1,105,4,1,0,0,16,0,8,30,0,0,2,4,1,4,10,0,17,21,4,0,5,3,1043,23,7,30,1,4,8,0,109,5,3,3,0,0,2,10,2,7,13,2,29,4,3,0,0,0,1,0,1,0,3,4,18,1,4,3,41,0,3,2,5,0,0,2,16,1,0,0,4,1,0,71,0,1,15,0,7,47,10,26,20,4,5,1,0,0,0,2,2,31,0,2,2,0,0,2,0,1,6,0,0,10,7,1,2,3,5,2,9,0,1,2,0,0,6,0,33,1,5,4,39,0,0,21,0,9,5,0,5,22,3,0,0,0,0,13,1,1,1,3,12,0,8,0,1,2,44,11,1,1,0,0,2,1,16,0,1,1,1,1,34,17,4,3,0,4,6,0,0,0,1,2,1,2,2,0,7,7,11,11,0,9,0,2,7,1,0,0,4,23,2,4,8,385,5,0,7,0,1,20,2,0,1,0,13,0,0,1,1,12,3,999,0,1,1,0,77,0,19,2,2,7,1,2,4,1,4,2,1,3,8,2,25,1,3,0,5,0,1,3,10,1,4,0,0,11,49,0,0,1,1,6,0,6,3,0,0,94,20,5,1,0,0,0,11,1,31,0,0,154,1,1,8,6,2,0,2,2,2,0,0,2,1,1,0,23,1,0,1,1,0,0,1,16,6,7,0,40,3,0,0,0,1,2,3,3,20,6,1,1,0,1,0,0,3,25,48,11,0,0,1,1,0,1,2,5,27,7,0,0,5,2,215,11,2,7,8,0,0,0,2,11,7,3,2,125,1,23,1,4,3,0,1,13,0,3,0,0,22,0,0,265,0,0,0,0,1,0,1,10,1,0,514,7,0,3,2,2,124,3,1,0,1,4,5,3,1,0,0,0,1,13,0,2,0,0,1,0,3,3,0,5,2,9,1,2,0,0,3,0,0,0,1,60,16,43,0,1,0,0,119,0,0,1,1,3,0,12,0,0,1,2,3,3,1,5,4,0,3,0,2,1,0,1,0,1,2,2,0,0,12,1,5,0,5,0,0,4,0,15,2,0,44,3,5,5,1,3,0,3,3,509,54,3,1,1,1,1,1,2,1,156,0,3,0,1,0,0,2,505,1,7,26,0,2,4,0,1,0,0,2,6,0,7,0,1,0,0,7,0,1,0,1,0,4,0,0,17,0,5,0,7,1,0,0,0,6,7,0,1,2,18,1,1,0,2,1,5,5,2,3,1,1,75,0,0,34,0,0,1,17,7,0,1,0,5,1,1,2,1,1,22,7,24,3,0,0,0,594,18,0,3,0,0,1,0,0,2,8,2,19,9,0,4,4,2,0,2,1,1,2,4,0,3,0,7,2,0,7,15,13,3,10,0,0,7,0,0,0,11,2,3,0,0,2,0,5,0,1,4,0,2,0,4,0,0,6,0,0,1,1,0,0,0,0,5,1,1,1,7,5,0,20,1,2,5,2,0,0,66,1,0,8,0,0,18,1,0,0,0,3,1,0,4,0,0,465,0,1,0,2,0,0,0,0,72,1,0,0,0,5,2,0,7,1,51,1,4,0,0,0,0,457,10,0,58,5,27,1,1,0,0,0,0,0,0,0,0,19,0,1,1,17,1,0,477,0,1,0,0,0,0,0,3,0,4,0,0,3,0,0,0,0,7,265,3,0,0,0,0,0,1,0,0,0,0,0,0,1,0,2,0,0,0,0,0,5,9,0,0,0,1,0,8,20,0,0,1,0,0,0,0,0,2,0,0,0,0,1,0,0,0,0,0,28,3,140,0,0,1,0,2,4,0,0,0,0,2,0,1,1,45,5,0,0,387,0,0,0,0,0,0,0,1,1,2,0,2,0,0,0,0,1,5,0,4,2,1,0,2,83,0,2,0,0,0,0,1,1,1,1,0,7,3,10,0,1,0,0,0,0,0,0,0,0,1,0,1,0,1,4,3,0,0,0,1,0,0,2,0,0,0,0,0,0,0,9,12,9,10,22,0,1,3,1,0,3,1,1,0,0,2,0,0,10,0,0,0,0,0,6,0,0,0,0,0,0,2,0,0,0,2,1,0,0,0,0,1,0,0,1,0,1,0,0,1,1,0,14,0,0,0,0,0,0,1,0,4,235,0,0,3,3,0,0,0,0,0,0,0,1,0,0,0,0,1,0,0,2,2,1,0,1,0,1,1,0,0,3,0,0,7,0,0,0,0,0,0,0,0,1,6,0,2,0,0,0,0,1,9,0,0,24,0,0,22,0,0,1,0,0,1,0,0,0,2,0,0,1,0,1,0,0,0,188,0,1,1,3,0,0,0,0,0,0,0,0,0,0,3,2,0,187,0,0,0,0,0,0,1,0,0,0,0,0,0,0,0,0,0,0,0,0,0,0,1,1,0,0,0,0,0,0,1,0,1,0,0,0,4,0,0,0,0,0,0,0,0,1,0,0,0,0,0,0,0,2,0,0,0,0,0,0,0,0,0,0,0,0,0,0,0,0,0,0,1,0,0,0,0,0,0,0,0,0,0,1,1,0,0,0,0,0,0,0,0,0,0,0,0,0,0,0,0,0,0,0,0,0,0
"Stomach Cancer",1793,667,731,9280,332,3665,325,263,889,668,243,1026,258,321,95,205,7170,609,387,545,532,206,16113,534,80,86,476,6079,519,91,612,2435,185,50,80,886,221,150,323,97,7858,2926,310,174,126,490,56,43,518,9601,20,33,67,1608,193,141,158,1048,2152,612,1681,400,151,138,4292,179,1459,1670,38,290,636,36,118,106,130,293,32,645,148,1334,414,1647,2946,722,1700,24,4142,97,25,162,192,803,1095,22,285,29,146,28,29,631,199,273,1648,33,44,94,240,127,41,9082,180,43,92,132,716,29,135,129,135,61,139,24,34,652,148,236,5701,88,181,342,130,1789,3104,150,337,502,231,44,202,8312,32,209,112,97,292,323,44,152,20,179,1574,49,704,112,100,97,346,403,352,63,16,56,15,14,14,59,4578,629,123,70,1454,24,94,648,105,26,215,81,149,20,13,1971,1547,11,34,119,16,33,19,76,256,49,53,112,13,127,138,38,23,134,6,10,113,26,12,167,202,546,8,1674,50,37,1887,256,67,419,2458,19,43,40,940,44,15,41,21,49,49,759,243,219,286,425,52,3,16,111,101,1187,13,16,20,9,1296,51,26,234,38,18,431,69,63,27,45,43,104,142,12,241,50,139,194,9,58,1073,3593,16,742,1012,213,44,104,89,31,27,6,4,173,18,11,245,139,26,28,395,15,17,244,16,9,9,18,4,401,55,23,535,11,22,140,76,5,210,59,300,7,301,33,7,641,20,14,13,141,69,514,96,12,7,655,1,266,17,46,53,14,222,384,17,8,5,9601,115,95,8,63,9,7,8,1,165,679,154,58,175,62,7,41,131,21,12,8,9,11,7,7,900,396,107,6,13,14,10,103,5,241,322,7,115,5,7,7,898,40,105,17,7,5,5,33,31,101,39,52,91,8,7,48,209,3,73,24,167,1,10,12,158,2461,6,61,7755,576,160,16,20,239,4,30,81,1156,7,6,5,20,205,561,16,17,187,40,10,217,64,79,49,12,5,7,26,13,27,0,51,33,40,12,5,3,14,7,44,24,22,5,16,6,218,5,43,3,2,22,61,187,85,6,0,2,11,27,28,154,21,4,4,5,107,805,2,1,22,8,105,4,12,667,45,26,126,31,4,0,39,12,227,14,1,40,27,56,7,245,13,118,11,241,1,12,118,4,21,14,9,256,3,33,7,23,1,255,16,8,1565,53,10,1,18,38,140,10,37,13,12,46,133,10,637,21,43,2,13,3,62,394,2033,11,28,85,22,28,158,161,36,88,5,118,13,46,17,27,36,6,10,4,4,148,256,195,34,130,625,43,12,6,41,7,70,17,4,13,6,469,3,97,69,5,6,23,11,9,5,17,8,201,15,8,6,141,5,1,3,88,8,26,59,14,18,38,10,87,915,12,1,216,418,1,6,103,5,198,6,99,180,0,50,17,111,61,11,9,37,292,88,148,181,7,19,1,24,1,23,748,1,845,45,138,13,3,21,3,25,127,4,15,37,272,282,6,2,23,53,7,9,3,6,0,225,4,21,61,4,5,16,10,3,33,43,4,13,13,298,15,6,12,5,250,6,42,1,77,11,35,16,1061,87,186,53,11,149,75,7,228,218,285,1,14,6,7,11,8,27,93,17,15,3,0,1,11,9,4,17,43,0,29,18,14,99,178,0,3,34,42,84,25,2,215,27,29,1,0,4,31,91,73,6,29,29,10,5,0,164,24,11,8,43,9,4,155,0,5,3,490,21,1508,3,4,456,1,7,11,22,28,48,2,15,25,237,34,13,13,37,6,4,2,1,55,5,7,4,1508,16,5,86,15,4,45,5,6,2,9,37,8,4,484,8,29,0,1,3,20,893,3,16,0,5,6,6,4,4,1,43,16,2,28,1,306,5,3,236,7,12,3,3,46,6,0,15,1,5,2,7,1,62,5,4,26,424,5,16,0,3,40,0,10,77,2,3,6,1,0,2,5,100,3,103,16,103,3,90,2,0,1,28,13,45,214,0,5,10,10,50,4,84,6,6,1,56,39,6,2,43,1,10,171,21,4,0,6,5,0,3,980,31,7,20,49,104,11,92,18,185,6,11,28,3,4,7,9,31,102,4,6,2,1,24,92,13,21,3,215,10,0,1,1148,2,6,8,76,8,91,71,8,52,27,8,40,1,12,1,5,8,4,181,26,303,0,518,49,0,233,5,135,1,232,7,3,0,7,4,11,870,677,3,33,709,114,4,203,0,5,5,5,18,7,5,5,3,70,95,28,3,5,3,0,29,1,64,14,0,30,1,7,12,15,1,60,4,11,0,19,4,39,8,244,7,2,7,78,17,4,2,23,24,0,208,0,19,7,8,2,0,194,33,4,1,1,12,10,210,8,0,5,1,498,340,2,11,78,171,1,0,0,3,1,4,19,25,3,6,54,4,6,2,7,3,1,0,15,9,28,55,4,0,155,10,0,46,0,0,43,220,3,2,51,0,1,1,255,21,444,1,41,7,4,191,3,2,2,1,1,2,2,35,203,0,54,6,3,2,7,2,66,18,4,1,0,5,22,1,558,1,0,2,0,5,12,2,7,5,25,6,0,33,263,3,1,1,7,3,2,5,3,123,3,14,1,5,2,2,21,2,10,11,66,1,14,3,2,1,39,26,1,835,94,10,562,0,1,35,3,3,2,1,282,19,0,2,27,15,33,2,0,0,8,412,2,3,6,11,12,189,8,0,84,68,622,0,9,5,47,1,0,7,30,0,11,0,2,159,6,1,2,1,477,20,15,18,4,6,1,2,19,3,938,2,0,1,2,74,16,21,1,2,36,3,3,129,91,25,2,0,26,8,27,5,29,1,238,25,0,5,2,1,1,119,43,16,19,1,12,3,43,12,0,32,94,20,4,12,1,103,2,4,27,2,0,91,2,38,362,44,13,4,10,1,2,2,354,6,7,5,1,5,3,5,1,352,0,274,7,0,89,13,2,14,171,1,16,1,3,7,12,158,3,4,10,7,0,2,5,6,31,0,5,5,20,17,0,0,2,0,7,1,11,2,6,72,4,16,4,8,11,34,20,3,9,17,0,2,6,0,11,1566,8,26,20,10,0,14,3,9,27,0,0,1,0,10,5,0,2,2,712,1,50,10,299,33,19,3,89,1,0,40,0,0,4,2,7,17,1,2,1,2,8,40,1,3,1,35,80,1,1,0,39,71,76,21,0,10,53,12,2,1,1,10,0,1,1,4,10,14,30,546,0,8,31,0,1,0,13,115,3,21,1,6,59,4,2,6,7,2,20,1,4,3,0,8,57,0,0,1,150,8,0,13,5,10,36,10,1,11,0,0,2,4,14,11,2,11,0,323,1,0,5,0,15,21,32,83,4,92,4,0,0,49,3,13,0,7,0,1,0,5,3,21,57,1,19,0,2,49,0,3,22,14,0,1,7,1,2,0,21,17,7,3,4,0,6,3,0,1,1,0,14,0,4,67,2660,10,10,0,3,0,4,56,0,2,22,0,34,11,2,10,0,2,1,2,3,7,3,5,8,0,3,2,0,22,6,0,1,19,2,12,0,14,2,9,7,3,0,2,6,1,23,0,103,19,2,0,46,22,8,0,109,0,3,0,1,5,1,32,77,0,49,7,5,26,2,2,0,16,2,21,62,0,0,1,45,0,0,448,0,51,1,0,15,1,1,403,1,19,10,10,4,4,0,462,1,0,0,0,1,0,0,10,0,10,101,1,59,0,2,36,2,4,7,16,17,0,0,1,1,2,6,0,0,36,0,3,0,6,46,114,9,0,4,4,1,2,3,6,1,0,112,32,67,13,5,127,15,7,56,0,6,11,11,13,123,1,1,15,2,1,0,4,12,0,1,3,18,4,1,1,10,5,1,14,1,10,1,5,0,43,1,4,9,6,0,0,3,0,3,0,132,0,0,0,14,1,16,2,0,2,10,0,1,5,1,6,1,1,1,0,27,0,5,2,23,0,4,0,1,0,0,4,66,13,0,17,2058,274,11,49,1,254,1,3,1,1,2,0,1,2,2,0,108,0,2,1,0,3,0,2,2,0,0,4,0,2,3,38,2,0,1,7,1,0,6,0,1,11,1,4,0,0,15,2,1,0,4,23,6,36,4,0,1,2,19,9,0,0,14,0,1,1,5,0,3,0,1,1,0,1,14,2,0,2,2,29,0,2,3,0,4,2,2,12,74,4,1,6,6,0,0,49,8,67,0,6,0,20,0,27,3,1,1,5,1,0,167,17,34,17,4,1,11,2,1,29,0,0,129,1,7,2,23,1,1,0,2,3,0,1,34,1,11,7,3,18,18,23,0,8,0,47,1,0,0,10,10,0,0,0,1,1,1,16,0,0,19,6,2,81,0,4,1,16,5,7,12,4,190,0,42,0,13,0,4,0,1,0,7,9,26,334,11,4,3,24,68,7,1,3,1,1,0,0,0,10,0,8,0,0,17,0,5,1,0,0,1,2,0,0,2,9,65,0,0,0,13,0,2,0,1,0,59,0,0,0,1,17,1,0,2,5,0,4,33,0,42,1,3,3,0,4,10,0,13,1,0,15,0,0,3,3,256,1,0,4,3,0,2,14,7,0,0,0,4,17,0,0,1,34,9,0,0,1,1,3,3,6,1,0,0,4,13,0,2,9,0,0,65,2,0,3,0,5,1,19,0,6,346,0,0,31,1,0,0,0,0,30,4,0,10,2,2,0,1,1,1,0,1,32,1,134,8,2,0,3,0,0,4,3,0,2,0,13,1,6,1,1,27,1,12,0,1,28,6,0,0,1,3,3,88,1,1,2,7,3,3,0,4,3,0,16,1,11,0,3,0,4,4,3,37,0,0,0,0,0,2,0,1,32,0,3,2,85,2,10,5,7,1,0,0,0,1,3,0,2,3,129,2,0,0,4,2,0,1,0,6,0,1,0,0,0,15,6,1,8,2,0,11,0,2,5,17,3,74,0,0,6,1,0,6,0,3,0,0,0,1,0,51,5,20,2,0,75,1,3,0,1,5,0,0,14,46,0,164,0,1,1,0,124,4,10,2,4,20,7,4,1,0,1,7,0,0,11,3,93,0,3,3,2,1,98,1,1,0,1,3,0,4,1,0,0,10,0,0,0,1,272,0,1,3,8,2,0,0,112,3,2,1,0,0,3,1,1,1,0,34,2,0,1,12,0,0,2,0,4,3,0,0,0,1,7,0,0,0,0,0,1,0,6,3,1,9,1,1,0,1,8,4,394,1,0,2,1,1,0,2,25,1,0,13,0,1,1,32,0,3,53,2,4,4,0,11,5,0,8,51,1,0,0,0,3,3,0,51,4,1,1,0,10,6,0,0,10,0,3,1,0,0,0,0,4,0,15,0,1,3,0,0,2,5,1,13,5,7,39,0,11,1,1,1,0,0,17,0,0,0,0,2,0,27,6,33,0,4,28,0,2,0,0,0,18,0,4,0,11,21,4,0,0,1,0,3,1,1,2,20,1,0,0,1,5,0,0,9,2,0,1,2,2,0,3,0,1,5,1,12,2,0,1,6,52,2,0,55,2,52,0,1,4,20,1,1,0,253,0,0,20,3,11,0,1,4,0,0,3,3,2,2,0,15,3,5,0,1,4,4,1,18,8,13,0,2,1,1,0,7,1,0,2,1,2,0,14,0,1,12,5,0,0,0,27,1,0,1,9,0,27,0,1,4,0,0,0,3,10,1,20,0,16,23,2,0,25,1,2,2,0,0,34,12,3,10,0,51,0,2,10,0,17,0,0,1,0,0,5,1,1,2,2,8,2,0,0,25,0,3,0,312,0,0,2,4,0,154,12,1,6,0,2,1,872,0,2,0,110,0,1,1,90,1,0,0,7,0,2,10,8,0,1,9,1,0,1,0,0,2,1,1,0,13,1,0,1,0,0,3,2,1,0,24,188,0,0,0,0,0,0,0,0,5,4,33,5,0,1,2,0,1,0,1,1,1,0,0,0,2,0,4,1,0,0,1,0,1,0,0,0,3,0,0,8,0,16,0,0,0,39,0,2,6,2,1,1,0,4,3,1,0,0,0,0,0,1,10,1,3,0,0,2,48,1,8,2,0,0,1,2,3,67,0,0,0,0,1,9,19,0,1,0,0,1,3,12,4,0,0,0,0,0,0,0,0,1,0,2,0,55,3,0,1,0,0,1,7,1,2,4,1,1,0,6,0,0,0,1,1,3,5,0,0,2,2,0,0,0,1,1,0,1,1,0,0,0,0,0,1,0,1,0,1,0,0,1,6,1,0,0,0,0,1,11,0,0,0,1,4,0,117,2,1,2,0,0,0,0,8,16,0,1,0,10,0,0,0,0,0,0,0,0,0,0,1,0,0,1,0,0,1,0,1,1,0,0,0,0,0,1,4,2,0,0,0,0,1,4,0,2,0,2,0,0,2,1,0,0,0,0,2,1,2,0,0,0,0,1,0,3,0,0,1,2,17,0,0,12,0,23,4,0,0,0,0,0,0,0,1,29,0,0,0,0,1,0,0,1,1,1,3,0,4,0,0,0,0,14,0,0,1,1,4,0,7,0,0,0,3,0,29,0,4,0,1,0,1,0,2,1,34,0,0,4,1,0,1,1,0,2,1,1,0,0,1,0,3,0,8,0,1,0,0,1,0,1,6,1,4,0,2,0,0,0,0,1,0,1,7,19,8,12,0,0,4,0,0,0,0,6,0,1,0,0,0,1,0,1,2,0,0,0,0,0,0,21,31,0,1,4,0,0,5,1,0,0,1,0,2,1,0,1,0,0,0,0,0,1,0,0,0,1,0,0,0,0,0,1,0,1,0,0,1,0,0,0,0,0,3,0,1,0,2,0,0,0,2,0,1,0,0,0,3,4,1,1,0,0,1,0,1,4,3,0,0,3,1,0,256,2,1,1,0,2,0,0,20,0,0,0,0,1,0,0,0,3,0,0,0,0,0,26,0,0,0,1,1,0,0,0,0,0,0,7,0,0,0,0,1,1,4,1,0,3,1,1,0,1,1,0,1,0,1,0,0,1,0,0,0,0,0,0,20,0,2,0,0,0,6,0,0,0,0,1,2,0,13,0,1,25,6,1,5,0,0,0,1,0,12,0,0,1,0,1,0,0,0,0,0,0,6,0,0,0,1,0,0,0,0,2,0,0,0,0,0,0,0,1,0,1,0,0,0,0,0,0,0,0,7,0,0,0,8,0,0,0,1,58,0,11,0,0,0,1,1,2,0,2,7,0,0,0,2,0,2,0,0,1,0,1,0,0,0,1,12,190,0,1,0,1,0,8,0,0,2,2,0,4,0,0,16,0,0,2,0,0,0,0,0,0,2,0,2,0,9,0,0,0,0,1,2,1,0,1,0,1,4,62,0,1,0,1,3,5,0,1,0,0,0,0,2,1,0,1,2,6,1,0,1,0,0,0,0,0,0,1,21,0,0,0,0,0,1,0,2,0,0,1,1,46,0,0,0,0,7,0,0,2,0,0,0,0,2,0,1,0,0,4,0,0,0,1,1,0,0,0,3,0,1,0,0,219,1,0,9,0,0,0,0,0,0,0,1,13,4,2,0,6,0,0,0,0,0,0,0,0,9,0,0,0,0,6,0,0,5,0,0,2,0,0,0,0,3,0,0,1,0,0,0,0,1,0,0,0,2,0,0,1,0,0,0,0,0,3,0,0,0,1,0,0,0,0,0,1,0,1,0,3,0,1,423,0,3,15,0,0,0,0,5,17,1,0,1,0,0,0,3,0,1,0,2,1,0,1,2,2,3,0,11,0,12,0,0,0,0,0,0,0,0,0,1,1,1,1,0,1,0,0,0,0,0,1,0,0,0,1,0,2,0,0,2,14,0,1,0,0,0,6,0,0,1,0,0,0,0,0,0,0,0,21,0,0,1,0,0,28,0,0,19,64,0,0,0,0,0,0,0,1,0,0,0,1,4,0,1,0,0,2,1,0,0,2,0,0,3,0,0,0,0,0,0,0,0,0,0,0,0,0,3,0,0,0,0,2,0,2,0,12,0,0,0,1,3,0,0,0,2,0,0,0,0,1,0,0,4,0,0,1,27,0,0,0,0,0,1,0,0,0,0,0,3,0,0,2,3,0,12,5,0,0,10,1,0,0,0,22,0,0,0,0,0,1,0,0,0,0,2,1,0,1,0,0,0,1,0,0,0,0,0,0,0,0,0,0,0,0,0,0,0,1,0,0,2,0,1,3,0,0,1,0,0,0,0,0,0,0,0,0,0,0,0,0,3,0,0,0,2,1,133,0,0,0,0,1,1,0,0,0,4,0,0,1,0,9,0,0,0,4,0,0,1,0,0,2,0,0,0,0,0,0,0,0,0,0,0,0,0,1,0,0,0,0,1,1,0,0,0,0,1,0,0,6,0,0,0,0,0,0,0,0,0,0,0,0,0,0,0,0,1,7,0,0,4,3,0,0,0,0,0,0,0,0,0,0,0,0,0,0,3,1,1,2,0,1,0,0,0,2,0,0,38,0,0,1,0,0,0,0,0,0,2,0,2,0,0,0,0,0,0,0,0,0,0,1,0,0,2,0,0,1,0,0,0,0,0,0,0,0,0,0,0,0,0,0,0,0,0,0,0,0,0,0,0,0,0,0,1,0,0,0,0,0,0,0,0,0,0,0,0,0,0,0,0,0,0,0,1,0,0,0,0,0,1,18,0,0,0,0,0,0,0,0,0,1,0,1,0,0,1,0,1,9,0,0,0,0,0,2,0,0,2,0,0,0,0,0,0,0,0,0,0,0,0,0,0,0,0,0,1,0,0,0,0,0,0,0,1,0,0,0,1,0,0,0,3,0,0,0,0,0,1,0,0,0,0,0,0,0,0,0,0,0,0,0,0,0,0,0,0,0,0,0,0,0,0,2,0,0,0,0,0,1,0,0,0,0,0,0,0,0,0,1,0,0,0,0,0,0,40,0,0,0,0,0,0,0,0,0,0,0,0,0,0,0,0,0,0,0,0,0,0,0,0,0,0,0,0,0,0,0,0,0,0,0,0,0,0,0,0,0,0,0,0,0,0,0,0,0,0,0,0,0
"Testicular Cancer",707,109,158,2780,71,427,171,56,144,115,19,405,54,162,49,39,2243,75,115,87,80,66,3686,59,16,15,216,42,210,12,160,173,58,24,36,32,96,19,72,27,659,1562,110,24,84,38,7,12,118,39,21,78,32,136,31,8,31,34,318,673,618,77,22,59,1363,52,240,423,17,12,43,42,48,15,27,127,5,96,32,65,279,403,1189,70,767,86,957,38,2,49,48,272,50,97,118,17,23,1907,5,29,38,96,228,0,25,43,126,36,7,1878,25,3,41,94,252,70,61,12,25,42,23,8,10,182,7,84,401,69,75,16,17,198,606,35,441,88,49,16,219,27,10,47,38,23,61,22,16,68,2,33,359,10,154,40,49,11,99,107,54,14,8,4,12,7,9,18,91,11,12,35,217,5,18,21,18,89,49,23,104,7,0,385,232,14,4,108,359,11,6,24,66,19,17,17,11,216,42,8,22,81,6,0,134,16,19,27,81,539,4,218,4,2,712,119,12,206,86,2,32,15,60,11,0,24,3,16,81,47,14,4,17,204,4,0,1828,10,19,880,1,21,14,0,92,13,2,139,31,21,129,75,21,5,12,7,46,53,18,35,10,44,124,3,42,108,65,21,150,502,121,12,20,59,25,18,5,0,4,1,9,71,192,15,7,21,8,2,68,8,15,2,3,1,31,5,30,17,3,10,12,6,26,10,6,139,0,146,80,11,29,13,2,2,170,39,26,21,6,3,169,0,4,3,7,5,11,89,6,26,13,1,7,12,25,2,22,12,5,4,0,82,46,10,3,155,12,3,3,7,21,4,6,2,2,7,5,4,6,15,9,3,3,5,62,8,10,37,2,29,2,1,1,247,2,6,1,4,4,1,10,2,114,13,11,14,12,11,179,84,186,12,6,19,0,6,4,20,6,3,52,4,20,11,9,3,26,1,13,271,414,6,8,13,6,61,5,15,2,2,49,6,9,10,26,9,4,2,1,0,5,23,6,18,116,32,5,2,6,7,0,7,16,0,3,8,0,8,73,21,0,6,1,68,21,16,3,1,0,1,141,10,31,3,1,167,1,72,66,3,0,15,3,15,1,5,36,9,2,16,6,15,0,4,1,53,2,0,3,15,26,1,4500,5,9,3,190,2,4,18,12,7,1,0,114,4,8,2,12,1,59,3,7,160,6,3,3,22,3,24,23,3,19,0,5,4,9,579,0,5,0,2,2,2,51,34,1,15,12,2,17,89,168,9,15,1,63,20,31,5,65,1,0,3,0,0,172,2,4,1,4,32,22,6,3,5,10,36,6,1,0,6,15,0,86,13,0,2,14,1,7,9,1,0,4,1,15,2,12,0,2,2,20,1,5,9,8,1,18,3,3,2,8,44,57,4,1,1,2,2,2,2,20,4,0,1,2,28,7,4,2,7,153,5,48,28,2,14,0,40,0,12,120,0,59,4,3,5,2,1,397,8,41,0,6,26,460,13,6,1,16,24,6,2,3,1,3,18,2,6,0,0,4,10,1,8,17,196,2,1,33,9,7,1,3,5,28,1,25,0,9,3,32,9,24,15,72,1,145,96,6,1,17,23,87,0,47,15,3,1,1,32,61,7,4,0,3,2,24,1,0,0,3,4,15,0,1,41,6,0,0,3,2,52,0,3,10,13,7,4,0,6,11,3,8,0,0,15,1,7,0,32,5,10,1,9,3,0,17,2,7,3,9,3,176,1,6,65,0,1,0,22,5,19,5,37,3,29,10,4,2,10,3,42,9,1,2,4,8,1,68,13,0,544,2,2,3,0,0,0,3,18,0,0,73,3,29,0,0,0,2,7,4,3,0,364,9,4,0,3,0,6,2,0,4,2,2,6,0,7,5,6,11,1,6,2,0,5,2,1,0,20,0,12,1,2,46,82,12,27,1,0,22,1,3,298,1,11,0,1,1,0,2,16,0,1,1,7,0,86,0,1,1,17,6,4,44,1,0,1,3,10,3,11,0,3,0,10,11,2,1,5,1,2,62,2,1,0,0,1,0,3,171,4,3,5,15,13,17,19,9,39,2,5,4,0,0,2,4,8,2,2,2,0,0,3,19,2,10,1,33,5,0,0,52,0,22,1,8,1,59,7275,4,13,20,0,12,0,15,0,0,34,1,44,8,30,0,2,8,0,30,1,6,2,28,4,3,3,9,0,0,8,0,1,14,70,260,0,4,0,2,0,2,1,6,69,0,0,12,13,9,306,0,0,0,29,11,4,6,1,8,0,1,4,8,1,0,1,6,0,8,1,3,1,95,3,1,2,8,3,0,0,15,25,0,6,0,6,1,0,1540,3,8,2,7,8,3,1,1,2,1,3,0,7,6,1,1,8,3,13,0,0,0,5,0,2,24,33,1,0,1,0,1,10,2,0,1,1,1,4,27,10,0,0,15,15,1,2,0,0,7,7,0,1,69,0,0,0,71,34,8,0,2,3,2,1276,4,8,2,0,1,0,10,60,8,0,1,3,2,3,3,2,0,2,0,0,1,0,7,0,2,1,0,2,1,4,2,5,1,2,1,0,0,19,39,1,3,0,0,0,2,1,3,94,0,4,0,0,6,0,4,3,0,1,36,5,1,1,1,0,13,0,9,22,1,0,5,0,2,5,1,0,0,6,3,1,0,3,3,40,2,0,0,1,7,80,254,3,1,6,2,0,0,0,35,8,1,2,17,2,9,0,0,13,7,1,5,0,0,22,1,4,0,0,2,6,4,12,0,1,1,1,2,1,3,3,1,1,0,20,0,1,0,1,8,0,0,17,102,3,2,1,5,0,20,0,13,0,37,6,0,31,0,0,5,195,10,18,4,2,2,0,2,1,1,1,58,3,0,6,1,1,193,0,4,1,1,4,1,22,10,16,8,0,60,0,421,3,0,0,57,2,0,0,0,8,1,1,1,81,12,8,8,2,2,2,8,0,80,0,0,0,1,55,0,24,8,5,0,2,20,1,4,0,6,0,7,1,0,0,0,0,2,2,2,0,1,38,1,7,0,15,3,2,0,1,14,7,1,1,5,1,3,7,1,3,1,32,0,58,1,1,1,0,1,0,0,4,6,1,1,1,3,5,18,150,0,0,2,8,3,0,0,1979,0,0,1,0,4,4,0,213,0,0,1,13,1,3,1,51,15,0,0,1,8,0,25,4,1,1,5480,1,3,7,4,1,1,3,238,4,0,0,4,2,0,2,1,0,0,0,2,20,1,18,0,2,20,1,0,1,0,5,2,0,4,0,5,0,11,0,1,0,3,10,1,303,0,2,5,6,1,25,0,0,0,1,116,1,8,1,0,0,1,0,1,0,8,2,2,34,0,69,2,0,0,3331,0,0,1,0,0,0,1,2,4,21,2,1,10,208,1,0,1,4,6,1,0,2,2,0,1,1,4,4,40,0,3,0,23,2,0,0,0,0,0,0,1,17,0,4,0,1,1,2,1,52,0,0,1,0,7,3,2,4,1,0,0,0,2,0,0,1,13,1,1,1,0,1,0,1,0,11,2,0,0,8,3,22,0,0,0,0,1,0,4,0,1,0,0,0,37,2,4,0,54,2,0,1,2,2,0,2,2,0,25,0,4,23,71,0,0,6,15,0,1,0,0,2,2,2,0,14,0,19,2,0,432,3,0,1,0,3,4,132,1,4,3,19,0,1,3,0,1,0,1,85,0,1,1,1,0,0,0,4,0,1,2,14,1,0,4,0,0,0,0,0,3,0,1,1,2,1,5,9,1,1,1,6,1,1,3,2,2,0,0,0,13,0,2,71,0,0,26,0,1,2,2,2,209,1,0,2,1,0,0,8,31,1,1,5,1,0,1,0,3,0,1,18,340,2,0,0,0,0,123,0,2,1,42,1,0,0,13,0,3,0,3,0,3,0,37,2,1,1,3,1,1,2,0,2,1,0,1,1,28,1,3,2,1,0,0,0,2,2,0,0,14,52,0,0,35,3,4,45,4,23,0,3,0,0,0,0,1,0,0,0,5,0,0,4,1,2,0,3,1,0,8,0,1,0,2,17,1,0,0,0,0,0,1,0,0,0,0,2,0,0,7,0,0,0,0,16,6,1,3,1,0,0,1,13,0,0,0,0,0,0,3,0,1,0,0,0,0,0,1,0,7,0,5,1,0,2,0,0,1,0,0,14,2,0,1,1,1,0,0,0,0,11,1,1,0,3132,0,3,17,0,0,0,1,0,6,1,39,0,2,1,4,1,0,484,0,0,3,1,8,1,12,0,0,1,0,7,0,3,1,0,0,1,0,3,8,18,0,2,0,0,1,2,1,0,0,0,0,2,1,5,0,3492,0,1,1,1,1,57,1,1,0,6,3,2,1,0,10,2,2,0,2,0,4,2,0,1,2,1,145,5,1,4,5,7,1,5,274,1,0,0,1,0,0,2,0,0,0,0,16,0,1,0,0,0,1,189,1,0,0,2,1,1,1,0,1,0,0,0,0,0,80,0,1,0,0,2,0,0,0,0,0,4,10,1,17,2,1,2,0,0,0,0,0,319,0,1,0,0,0,2,4,0,0,2,1,0,1,26,2,0,0,0,3,2,0,0,0,19,3,0,0,0,13,0,4,0,0,0,0,0,2,0,1,1,0,0,34,0,0,2,0,0,0,0,0,0,0,0,0,11,1,0,262,0,0,3,8,0,176,1,0,0,0,2,1,2,0,11,0,8,4,0,0,0,0,0,2,0,0,2,0,3,0,2,5,0,5,0,0,0,1,47,11,0,0,0,1,0,41,0,0,0,1,0,1,0,1,1,0,52,1,2,0,0,1,4,0,2,26,0,13,0,0,0,3,0,1,22,0,1,0,9,0,2,0,3,0,0,0,0,2,4,0,1,11,9,1,0,0,2,2,0,1,2,1,0,0,0,1,0,5,8,1,7,0,0,3,0,3,0,2008,1,0,0,0,4,5,0,13,0,0,0,0,0,1,0,4,1,5,1,0,13,0,1,0,207,13,0,0,4,21,1,97,1,0,0,0,1,11,332,0,0,2,1,7,2,1,0,4,0,0,0,1,0,0,0,0,10,5,0,0,0,0,0,2,0,0,0,0,0,1,0,3,1,0,0,0,0,1,0,1,0,5,19,0,2,0,0,0,0,0,0,0,0,6,0,0,2,0,0,0,0,0,3,5,0,6,0,0,0,0,1,0,3,0,0,0,468,1,0,2,0,0,1,0,1,0,0,0,1,0,1,0,0,0,26,5,0,1,1,0,0,7,5,4,11,0,4,0,2,1,0,0,3,2,0,0,0,0,0,0,0,30,1,0,0,0,4,15,0,0,6,0,0,1,0,0,0,1,5,1,8,0,0,10,0,0,0,1,0,4,2,1,588,0,2,0,0,0,1,0,4,0,0,0,0,1,0,10,58,0,0,0,2,2,0,0,0,0,1,0,6,0,1,28,4,0,0,5,0,7,0,0,1,32,0,0,0,2,2,1,2,9,28,0,0,0,0,0,0,0,12,0,0,0,1,0,0,1,42,1,0,1,1,24,0,0,0,0,0,0,0,0,0,0,1,3,2,0,1,0,0,0,0,0,2,0,2,6,5,0,2,0,0,1,0,17,11,2,0,1,0,0,0,33,0,1,0,0,2,0,8,0,2,2,4,0,0,0,5,0,0,1,0,2,56,0,0,1,0,0,0,0,0,0,4,1,0,12,0,0,2,0,0,0,1,1,44,2,0,3,0,3,0,6,0,1,1,0,0,0,0,5,20,0,0,0,0,1,0,0,0,0,0,6,0,0,6,0,2,4,1,6,1,0,2,0,0,0,5,0,0,0,4,0,0,0,0,0,0,0,3,0,0,0,4,0,0,0,0,0,0,3,0,1,0,0,0,0,0,1,0,0,0,0,1,0,0,93,1,0,0,0,0,1,0,0,0,15,0,432,12,0,1,8,0,0,0,0,0,1,0,0,4,0,0,0,5,0,1,2,0,0,3,0,0,1,5,0,0,0,0,0,0,0,11,0,1,2,1,1,1,0,3,0,0,0,0,0,0,0,1,4,0,1,0,4,1,10,2,0,2,0,0,3,0,0,3,0,0,0,0,5,0,12,0,0,3,0,0,0,4,0,0,0,0,1,0,0,0,0,0,0,2,158,1,1,0,0,0,0,1,4,0,5,1,2,0,15,4,0,0,0,0,1,0,1,0,0,1,1,0,0,0,0,0,1,1,1,1,7,1,2,0,8,1,0,0,0,1,0,0,0,1,0,0,0,0,0,1,0,0,0,2,2,0,3,0,0,2,0,0,0,0,1,4,1,1,0,2,0,1,0,0,0,0,1,0,0,1,0,0,0,1,0,0,0,0,0,0,0,2,4,0,0,0,0,2,1,0,0,0,0,0,0,0,0,0,4,1,0,0,0,1,1,0,0,0,0,0,0,0,0,2,1,0,0,0,1,0,0,0,0,1,0,1,1,0,0,0,0,0,0,0,1,6,0,0,0,0,0,1,1,0,0,0,1,7,0,0,0,0,0,65,0,0,0,0,2,1,0,0,0,0,0,0,14,0,1,1,0,0,1,0,1,0,7,0,0,3,0,0,0,0,0,0,0,0,0,0,0,0,1,0,221,0,0,0,0,0,0,1,0,1,0,0,0,0,0,1,0,0,1,2,1,0,1,7,0,0,0,0,0,0,0,1,0,3,0,0,0,0,0,0,0,0,0,0,0,0,0,0,1,0,0,0,0,0,0,0,0,0,1,0,0,0,0,0,0,0,0,0,0,2,3,0,0,0,0,0,0,0,0,56,0,0,0,0,2,0,2,0,0,0,130,3,0,0,0,0,0,2,0,0,0,2,0,1,6,2,0,0,0,0,0,0,0,0,2,0,0,12,0,0,0,0,0,0,0,0,0,0,15,0,0,2,0,8,0,0,0,20,0,0,3,0,0,10,0,0,0,0,0,0,0,0,2,0,0,2,0,0,0,0,0,0,1,0,0,0,0,1,0,0,0,0,0,0,11,0,1,3,0,0,0,0,0,0,1,1,0,0,0,0,6,0,0,0,0,0,0,0,2,0,1,7,2,0,0,0,0,1,1,0,2,0,0,1,0,0,0,0,0,0,0,0,2,0,1,0,0,0,0,0,0,0,0,2,0,0,4,0,0,204,0,2,0,0,0,0,0,0,0,0,2,5,1,0,0,2,0,0,0,0,0,10,3,0,0,0,0,0,0,2,3,0,0,11,0,0,0,0,0,0,0,0,0,0,0,0,2,0,0,0,0,0,0,2,2,0,0,0,1,2,1,0,0,0,0,1,0,0,0,1,0,1,0,2,0,0,22,0,0,0,0,0,24,8,0,0,0,95,2,0,0,0,0,1,3,1,0,0,0,0,0,0,0,0,0,2,4,2,0,0,0,0,0,1,0,0,0,0,3,1,0,0,0,0,0,0,2,0,0,1,0,4,0,0,1,0,2,0,0,0,1,0,0,0,0,0,0,0,14,0,0,0,0,0,27,3,0,0,0,0,0,0,0,20,0,0,0,0,0,0,0,1,0,0,1,0,2,0,0,1,0,1,0,0,0,5,0,0,0,0,0,0,0,3,0,0,1,0,0,1,0,0,0,1,0,0,0,0,0,0,0,0,0,0,0,0,0,0,0,0,0,0,0,0,0,15,0,0,0,0,0,0,0,0,0,0,0,0,0,0,0,0,2,0,1,33,1,0,0,0,5,0,0,0,0,0,0,0,0,0,0,0,0,8,0,0,0,0,0,0,0,0,3,2,0,0,0,0,0,0,0,0,1,1,0,0,0,0,61,0,0,0,0,0,0,0,0,0,0,0,0,0,0,0,0,1,0,0,0,2,0,0,0,0,0,0,0,0,1,0,0,0,0,0,1,0,0,1,0,0,2,0,0,2,0,0,0,0,0,4,0,0,0,0,3,0,0,0,0,0,0,0,0,1,0,0,0,2,0,0,0,0,0,0,0,0,0,1,0,0,3,0,0,0,0,0,0,0,0,4,0,0,0,0,0,0,0,1,0,1,0,0,0,0,0,0,6,0,0,5,0,0,0,0,0,0,0,1,0,0,0,1,0,0,0,2,15,0,0,2,0,0,0,0,0,1,0,0,0,0,0,0,0,1,0,2,0,2,6,0,0,0,0,0,0,0,0,0,0,0,0,0,0,0,0,0,0,0,0,0,0,0,0,0,1,1,0,181,19,0,0,0,0,0,0,0,0,0,0,0,0,0,0,7,0,1,0,0,2,0,0,0,0,0,0,0,0,0,0,0,0,0,1,0,1,20,2,0,0,0,0,0,0,0,0,0,0,0,0,0,0,0,0,0,0,0,0,0,0,70,0,0,0,0,3,0,0,0,0,0,0,0,0,0,0,0,0,0,0,0,0,0,0,0,0,0,0,0,0,0,0,0,0,9,3,1,0,9,0,0,0,0,0,0,0,0,0,0,0,0,0,0,0,0,0,0,0,0,0,0,0,0,0,0,1,0,0,0,0,0,0,0,0,0,38,0,0,0,1,0,0,0,0,1,1,0,0,0,0,0,0,0,0,0,0,0,0,0,0,0,1,0,0,0,0,0,0,0,0,0,0,0,1,0,0,0,0,0,0,0,0,0,0,0,0,0,0,0,0,0,0,0,3,1,0,0,0,0,1,0,0,0,0,0,0,0,0,0,0,2,0,0,0,0,0,7,0,3,0,0,0,0,0,0,0,0,0,0,0,0,0,0,11,1,0,0,0,0,0,0,0,0,0,0,0,0,0,0,0,0,0,0,0,0,0,0,0,0,11,0,0,0,2,0,0,0,2,0,0,0,0,0,0,0,9,0,0,0,0,0,0,0,0,0,0,0,0,0,0,0,0,0,0,0,0,0,0,0,0,0,0,0,0,0,0,0,0,1,0,0,0,0,0,0,0,0,0,0,0,0,0,0,0,0,0,0,0,1,0,0,0,0,0,0,0,0,0,0,0,0,0,0,0,0,0,0,0,0,0,0,0,4,0,0,0,0,0,0,0,0,0,0,0,0,0,0,0,0,0,0,0,0,0,0
"Thymoma",238,64,40,1161,51,133,93,21,24,159,124,67,40,44,32,58,1139,11,126,71,70,26,500,12,14,18,47,34,39,24,95,577,4,7,26,56,20,26,35,14,180,344,63,13,63,32,12,4,86,20,29,26,3,70,47,88,16,23,58,349,185,27,17,27,481,9,76,109,4,5,11,38,8,80,71,47,7,99,14,72,94,223,192,72,668,3,259,9,4,32,52,84,12,6,57,82,16,5,3,26,9,22,13,2,19,22,20,14,12,101,25,11,4,13,22,11,10,8,10,8,48,2,1,143,8,20,451,39,213,33,2,35,215,34,174,32,18,36,52,5,10,7,43,9,27,16,2,19,1,76,117,10,71,11,13,20,91,95,10,23,1,139,11,3,4,6,40,13,5,9,25,5,72,8,31,161,14,13,57,12,4,69,131,0,0,10,3,2,6,30,225,5,19,20,10,31,140,4,1,31,2,0,2,7,0,10,20,75,5,163,2,6,385,49,45,54,4,19,4,5,16,4,5,11,12,3,30,21,8,17,6,31,2,0,2,7,12,34,0,24,8,0,68,29,3,55,3,3,191,65,214,15,10,3,34,28,18,9,11,50,25,6,26,44,11,1,91,190,22,6,26,12,1,3,1,0,3,0,1,39,67,5,7,5,5,4,25,12,2,0,4,0,15,8,1,3,5,0,4,27,1,8,4,43,1,46,5,2,19,12,7,4,32,85,37,9,11,4,72,1,0,1,9,79,4,91,3,1,2,3,2,13,22,0,4,20,5,4,0,145,19,14,6,3,15,1,0,24,5,9,3,1,5,18,0,0,4,17,6,1,1,10,163,0,10,123,4,5,1,1,0,119,2,2,3,6,2,5,15,2,58,1,2,33,4,23,40,8,1,4,3,6,2,9,4,21,2,2,3,3,1,4,3,0,14,4,25,5,93,3,1,19,3,24,13,18,0,0,1,20,7,6,26,2,4,10,4,2,10,9,0,4,3,7,10,48,0,0,2,9,36,0,1,2,2,6,1,1,2,0,5,6,9,1,1,0,0,0,3,1,9,6,0,3,0,11,10,1,8,4,10,8,4,0,32,5,4,0,3,2,1,9,2,40,7,2,5,1,23,0,208,2,1,6,58,0,0,183,0,4,2,0,41,4,1,0,2,3,51,0,9,7,1,106,0,27,8,16,1,8,1,4,53,14,0,46,5,7,0,18,2,6,12,26,1,42,7,1,4,6,20,1,68,3,41,2,5,11,62,3,0,2,1,0,64,1,2,2,9,31,5,0,2,45,1,8,1,2,7,6,8,3,25,9,1,0,3,0,1,0,3,3,1,4,0,0,6,1,7,20,23,5,8,78,7,0,10,4,7,9,1,1,46,9,1,0,18,3,0,2,23,0,0,23,0,38,3,4,1,0,19,5,2,1,0,3,0,1,0,6,46,0,155,0,1,1,0,1,3,3372,19,0,4,232,139,2,9,0,5,2,0,8,7,0,0,0,1,10,0,0,0,2,3,5,29,2,0,1,15,2,9,1,7,7,20,1,0,0,6,1,21,9,2,45,64,37,2,48,1,5,16,33,5,0,0,2,0,0,0,0,0,1,1,0,1,1,1,1,1,2,0,0,2,0,0,27,0,0,0,1,4,22,0,0,7,8,0,1,0,0,31,1,3,6,3,2,9,3,0,6,1,3,3,21,0,1,3,0,0,1,3,5,158,0,0,123,1,3,5,8,2,5,8,1,0,12,9,1,0,4,1,2,0,2,78,3,3,3,12,4,0,15,1,0,2,6,3,1,26,9,4,9,14,17,3,0,0,0,2,0,22,0,0,2,2,8,2,1,4,3,0,0,3,3,3,4,6,5,4,14,1,6,59,7,4,2,0,5,0,3,1,4,0,1,59,20,0,14,0,0,22,0,5,8,0,1,0,0,0,3,0,114,1,1,3,2,7,8,1,1,1,2,0,12,34,1,4,2,0,1,0,2,1,1,0,4,57,3,1,16,0,0,9,3,0,2,4,0,0,12,16,1,1,10,11,1,4,27,6,23,3,2,32,1,0,2,9,73,9,0,5,0,0,1,37,3,20,0,2,11,0,0,17,1,2,2,8,2,12200,77,3,17,10,0,8,0,2,1,0,0,0,6,7,6,0,12,19,1,1,0,0,0,0,1,4,1,1,0,0,1,3,0,4,0,73,0,6,0,12,40,1,121,26,1,0,0,2,22,4,3,0,0,0,4,0,0,3,0,2,2,56,1,0,1,0,1,2,0,1,2,39,1,35,2,1,7,1,0,0,0,8,8,2,0,0,6,0,2,0,0,3,1,0,4,0,0,3,6,1,0,0,5,13,1,0,0,0,11,0,2,0,0,0,1,17,2,0,1,8,0,0,3,20,0,0,2,2,0,9,4,2,0,76,10,0,0,0,1,2,1,1,4,9,0,2,0,1,1,3,0,9,0,2,12,0,0,2,1,1,0,0,13,5,0,0,1,2,4,1,4,0,0,1,0,0,1,12,0,1,0,0,1,0,1,0,0,5,2,0,1,0,34,11,3,3,0,19,0,0,1,1,19,0,1,0,1,0,1,0,0,0,9,15,0,0,0,0,1,23,4,0,6,3,16,0,0,0,1,1,2,0,0,1,0,1,0,3,3,291,0,0,0,2,115,3,0,0,3,0,10,0,0,24,9,0,0,5,5,1,0,0,2,14,1,0,0,0,19,3,0,0,3,11,1,7,1,0,0,3,0,1,2,0,0,0,4,0,19,4,0,0,1,12,0,11,36,23,38,0,0,3,15,11,0,8,2,31,5,2,0,0,0,0,2,8,30,15,0,2,0,0,0,0,10,14,6,1,21,0,7,0,0,24,1,1,11,0,10,0,24,4,0,0,0,0,0,0,0,4,2,0,0,0,0,1,0,0,39,2,10,3,1,1,0,6,0,0,1,0,0,0,27,1,0,2,0,1,0,1,2,15,0,18,0,2,0,0,0,0,0,0,0,15,0,0,31,0,11,0,2,10,0,0,0,3,6,0,0,4,0,0,8,6,3,0,2,0,0,4,0,6,0,0,0,0,0,0,0,0,0,0,0,10,3,0,3,0,1,1,0,1,19,0,0,0,1,0,2,4,1,0,0,34,21,10,0,1,1,4,3,0,0,14,0,0,42,0,0,62,0,0,0,1,4,0,0,0,10,1,13,5,21,0,3,0,0,1,0,1,5,0,2,1,2,15,10,0,2,0,2,12,0,0,2,0,1,11,0,1,0,0,2,1,4,0,16,0,0,1,12,0,0,1,6,22,24,0,1,0,0,0,0,0,2,1,0,6,53,0,30,2,1,0,36,1,0,1,2,0,0,0,12,0,4,1,1,0,0,11,0,1,1,0,0,0,0,0,0,0,0,0,10,0,0,0,0,21,2,0,0,0,0,0,0,1,5,1,0,0,1,3,0,6,16,0,0,0,1,3,1,0,0,1,2,0,1,0,0,4,3,7,1,0,0,1,0,0,0,0,13,1,0,0,10,8,2,1,1,0,0,15,0,1,0,1,0,0,1,2,1,4,0,9,0,5,0,0,2,0,0,2,1,23,1,1,0,0,0,0,2,1,0,6,0,0,0,21,1,0,1,0,1,13,0,5,0,35,0,0,3,2,2,1,0,0,1,1,0,13,1,0,0,0,1,0,1,6,0,0,0,1,8,1,0,0,1,0,0,0,0,0,0,1,0,0,0,0,2,0,2,3,6,0,0,0,3,0,0,0,1,0,0,5,0,3,3,1,0,0,2,11,0,2,1,0,4,39,1,0,0,0,0,0,1,1,0,4,6,26,2,0,0,1,2,1,129,0,0,1,0,1,0,2,1,0,2,0,0,0,0,0,0,1,1,0,0,8,1,0,0,0,0,9,0,0,7,0,1,1,2,0,0,6,0,2,1,1,1,0,0,0,0,0,0,15,1,0,1,4,4,0,21,0,19,0,9,1,0,1,0,0,2,0,1,5,0,1,1,12,8,0,0,0,0,0,0,2,0,0,3,0,0,0,3,6,0,1,1,0,0,0,5,0,0,3,0,0,0,0,1,2,42,2,0,0,0,0,3,0,0,0,0,1,0,3,0,1,0,0,0,1,0,0,0,0,0,0,0,0,0,0,0,2,0,0,3,0,2,1,4,0,0,0,0,0,12,1,5,1,1,0,0,2,0,0,0,0,1,11,18,3,1,1,0,3,7,2,5,0,0,3,2,28,8,5,0,1,1,10,0,0,0,8,0,0,1,0,16,4,10,0,0,0,0,2,0,0,1,0,0,0,0,0,0,0,1,0,0,3,0,0,14,0,0,1,10,9,0,15,1,12,7,0,0,33,0,4,6,1,0,0,4,0,0,1,0,3,2,0,8,1,1,0,0,0,0,0,0,0,1,1,0,256,0,0,0,0,0,0,2,5,0,0,4,0,3,0,0,21,1,0,0,0,0,20,0,0,0,3,3,0,0,0,0,0,0,1,0,4,1,0,1,1,0,2,0,4,0,0,5,0,0,3,10,0,0,0,0,0,0,0,4,0,0,0,1,0,1,0,0,0,23,1,0,1,0,0,0,0,2,0,1,0,0,32,0,0,0,0,0,9,0,0,0,0,0,0,0,0,0,0,3,0,0,0,0,0,0,0,1,2,0,1,0,0,0,0,0,0,0,0,4,0,2,0,3,0,1,0,0,0,1,0,0,0,10,17,1,0,0,2,0,0,0,0,3,6,0,0,0,0,0,7,0,1,0,0,354,1,0,0,1,0,1,0,2,0,0,0,4,0,0,0,0,0,0,0,0,3,0,0,0,0,6,0,3,23,0,0,0,0,0,0,0,2,1,0,0,0,17,0,0,0,1,0,0,0,0,1,0,1,0,0,0,1,1,0,1,0,0,1,0,0,0,0,1,0,0,0,1,0,1,0,0,0,0,0,0,3,0,0,1,7,0,0,2,0,0,0,0,0,0,0,1,1,4,0,0,5,0,3,1,2,3,0,0,0,0,0,0,0,0,1,0,0,0,1,1,0,0,0,0,0,0,0,0,0,0,0,0,0,0,0,0,3,0,0,5,0,0,0,0,0,1,0,0,0,6,0,0,0,2,0,1,0,0,1,0,0,0,0,0,1,0,0,0,0,3,0,0,0,0,0,0,0,0,1,0,1,0,0,0,1,1,2,0,0,6,0,1,0,0,0,0,2,2,0,0,0,5,2,0,1,0,3,0,1,0,0,0,0,0,0,0,0,3,0,0,4,0,0,0,0,0,4,0,17,1,0,0,0,0,0,0,0,27,0,0,1,0,0,0,0,0,0,1,0,0,0,0,0,0,0,0,0,2,0,5,0,11,0,0,1,0,0,0,0,0,0,0,0,1,2,91,0,0,1,0,0,0,0,0,0,0,2,1,0,0,545,1,0,0,5,0,0,0,2,20,0,1,0,0,0,0,0,1,0,1,1,0,0,2,0,0,0,0,0,0,1,0,0,0,0,10,22,0,0,0,1,0,0,0,0,0,0,0,0,0,0,29,1,0,0,0,0,0,0,0,1,4,0,0,26,19,0,0,0,0,1,0,6,1,0,0,1,0,0,0,1,0,0,0,0,0,1,5,0,0,4,10,2,0,0,0,0,0,1,0,1,12,0,2,1,0,0,0,0,0,0,3,0,1,0,0,0,0,0,1,0,0,0,0,0,0,0,0,2,0,7,0,0,1,0,0,1,0,0,0,0,0,0,0,2,0,0,0,0,0,0,1,1,0,0,0,0,0,0,7,0,0,1,0,0,3,0,0,0,6,0,0,0,2,0,0,0,3,0,0,0,0,0,1,0,0,1,1,0,3,0,0,0,1,0,0,0,0,0,0,0,0,0,0,0,3,0,0,0,0,1,0,0,0,0,2,3,5,0,0,3,0,1,0,0,0,0,0,0,0,0,0,0,0,1,0,0,0,1,0,0,0,0,0,1,0,0,0,0,2,0,6,1,0,0,0,0,0,0,0,11,0,0,0,1,0,0,0,1,1,2,0,0,0,2,0,0,0,0,0,2,1,0,0,0,0,0,0,1,0,4,0,4,0,0,0,1,0,0,0,0,0,0,0,0,0,0,1,0,2,0,1,1,0,0,0,0,0,2,1,10,0,1,0,0,0,0,0,0,0,0,2,0,0,0,0,0,0,0,0,0,1,0,0,7,0,0,0,1,0,0,0,0,0,0,0,1,0,22,9,0,0,1,0,0,0,0,0,0,3,7,0,0,0,0,5,0,0,0,0,0,3,0,0,0,1,0,1,1,0,3,0,0,0,0,0,0,0,0,0,1,0,1,1,0,1,0,0,0,0,1,0,0,0,0,0,0,0,0,1,0,0,0,1,1,0,0,0,0,0,0,0,0,0,0,0,1,0,0,1,3,0,1,0,0,0,7,0,0,0,0,0,2,0,0,0,0,0,0,0,0,0,0,0,0,0,0,0,0,0,0,0,0,0,0,1,0,0,1,0,0,0,0,0,1,0,0,0,0,0,0,0,3,0,0,0,1,0,0,0,0,0,1,0,0,43,0,0,0,0,0,0,1,0,0,0,0,0,0,0,2,0,0,0,0,0,0,0,5,0,0,0,0,0,0,0,0,0,0,0,0,1,0,0,0,0,0,0,0,2,0,1,0,0,0,0,0,0,0,0,0,0,0,0,0,41,0,0,1,0,1,1,1,0,0,0,0,0,25,0,0,0,0,0,1,0,0,1,0,0,0,0,0,0,0,0,0,0,0,1,0,0,0,0,6,0,0,0,0,0,2,0,0,0,0,0,0,1,0,0,0,0,0,34,0,0,1,1,0,0,1,0,0,1,1,5,0,1,2,0,0,3,0,0,0,1,0,0,0,22,0,0,0,1,1,0,0,1,0,0,0,0,0,3,0,0,0,0,1,0,0,0,0,1,1,0,0,0,0,0,0,0,1,0,0,0,0,3,0,0,0,0,0,0,0,0,0,5,0,0,0,0,0,0,11,0,0,0,0,0,3,0,0,0,0,0,0,1,2,0,1,0,3,1,2,0,0,0,1,0,3,0,0,0,0,0,0,0,0,0,0,0,1,0,0,0,0,0,0,1,0,0,0,0,0,0,0,0,0,0,0,0,0,0,0,1,0,0,0,0,0,1,0,0,0,1,0,0,0,1,0,11,0,0,0,0,0,0,0,13,0,0,0,0,2,0,0,0,0,0,0,0,0,0,0,0,0,0,0,2,0,1,0,0,0,0,0,1,0,0,0,0,3,0,0,0,0,0,0,0,1,1,0,0,1,0,0,1,0,0,0,0,1,0,0,0,0,0,0,0,0,0,0,1,0,0,0,0,0,0,0,0,0,0,0,0,6,0,27,0,0,0,0,0,0,0,0,0,4,0,0,0,0,0,1,0,0,0,0,0,0,0,0,0,0,0,0,0,0,0,0,0,0,0,0,0,0,0,0,0,0,0,0,0,0,0,1,1,0,0,0,0,0,0,0,0,0,0,0,0,0,0,0,0,0,2,10,0,0,0,0,0,0,0,0,0,0,0,0,3,0,0,0,0,0,0,0,0,0,0,0,0,0,0,1,0,0,0,0,0,1,0,0,0,0,0,0,0,0,0,0,0,0,1,0,0,0,0,0,1,0,0,0,0,48,1,0,1,0,0,0,0,0,0,0,0,0,1,0,0,0,0,0,0,0,0,0,0,0,0,0,0,0,0,0,0,1,0,0,0,0,0,14,0,0,0,0,0,0,0,0,0,0,1,0,3,2,0,0,0,0,0,0,0,0,0,0,0,0,0,0,0,0,2,0,1,0,0,0,12,0,0,0,0,0,0,0,0,1,0,0,0,0,0,0,0,0,0,0,0,0,0,0,0,1,0,0,1,0,0,0,0,2,0,0,0,0,0,0,0,0,0,0,0,0,0,0,0,0,0,0,0,0,0,0,0,0,2,0,0,0,0,0,0,0,0,0,0,0,1,0,0,0,0,0,0,1,0,1,0,0,0,0,0,0,2,3,0,0,0,5,0,0,0,0,0,0,0,0,0,0,0,2,0,0,0,3,0,0,2,0,0,0,0,0,0,1,1,0,0,0,0,0,0,0,0,0,0,0,0,0,0,0,0,0,0,0,0,1,0,0,0,0,0,0,0,0,0,0,0,0,0,0,0,1,0,0,0,0,0,0,1,0,0,0,0,0,0,0,0,0,0,0,0,0,0,0,0,0,0,0,0,0,0,0,0,0,0,0,0,0,0,1,0,0,0,0,0,0,0,0,0,1,0,0,0,0,0,1,0,0,0,0,0,0,0,0,0,0,0,0,0,0,0,0,0,0,0,0,0,0,0,0,0,0,0,0,0,2,0,0,0,0,0,0,0,0,0,0,0,0,0,0,0,0,0,0,0,0,0,0,0,0,0,0,0,0,0,0,0,0,0,0,0,0,0,0,0,0,0,0,0,0,0,0,0,0,0,1,0,0,0,0,0,0,1,0,0,0,0,0,0,0,0,0,1,0,0,0,10,0,0,0,0,0,0,0,0,0,0,0,0,0,0,0,0,0,0,0,0,0,0,0,0,0,0,0,0,0,0,0,0,0,0,0,0,0,0,0,0,0,0,0,0,0,0,0,0,0,0,0,0,0,0,0,0,0,0,0,0,1,0,0,0,0,0,0,0,0,0,1,0,0,1,0,0,0,0,0,0,0,0,0,0,0,0,0,0,0,0,0,0,0,0,1,0,0,0,0,0,0,0,0,0,0,0,0,0,0,0,0,0,0,0,0,0,2,0,0,0,0,0,0,0,0,0,0,0,0,0,0,0,0,0,0,0,0,0,0,0,0,0,0,0,0,0,0,0,0,0,0,0,0,0,0,0,0,0,0,0,0,0,0,0,0,0,0,0,0,0,0,0,0,0,0,0,0,0,0,0,0,0,0,0,0,0,0,0,0,0,0,0,0,0,0,0,0,0,0,0,0,0,0,0,0,0,0,0,0,0,0,0,0,0,0,0,0,0,0,0,0,0,0,0
"Thyroid Cancer",1060,851,999,8650,176,803,217,181,764,321,310,686,160,213,224,255,3664,443,290,291,229,135,10731,378,67,52,239,194,212,139,218,380,98,434,150,151,267,131,87,56,3045,2008,290,236,272,329,29,406,309,128,56,84,90,444,106,184,98,203,1102,1735,2002,117,38,240,4227,81,1061,227,21,38,168,62,191,72,131,281,30,505,30,513,322,2279,9472,355,2365,89,1336,174,22,93,970,779,271,71,521,48,91,218,46,278,106,154,203,10,97,162,106,227,126,5896,100,36,325,282,113,103,162,94,123,134,82,24,33,1120,69,99,2606,34,156,108,32,235,839,79,235,171,144,43,207,128,96,90,41,111,139,163,73,113,18,45,1095,123,111,49,73,106,607,833,154,33,28,110,39,41,54,55,566,114,73,37,319,12,252,142,41,46,109,59,104,28,7,937,163,9,33,340,145,52,62,89,483,40,37,72,31,2094,170,54,126,779,17,21,68,64,38,84,105,1345,12,1963,14,60,1042,187,28,394,53,34,48,28,44,53,10,31,19,28,84,321,120,42,42,279,24,22,85,34,125,754,43,24,36,7,252,48,10,135,42,39,179,4971,199,8,6,15,136,260,23,198,11,100,416,15,3693,102,281,21,87,675,162,13,57,174,65,40,14,6,28,14,25,889,424,35,33,37,43,17,250,21,17,27,20,6,434,11,48,25,34,26,111,27,47,41,35,351,27,360,73,10,156,17,21,8,380,7625,184,64,311,18,21127,1,23,6,19,13,28,115,42,43,17,11,27,64,63,41,18,15,15,21,7,99,119,93,36,14,433,4,116,27,32,2,14,15,8,7,9,28,17,149,30,32,7,10,61,23,38,186,7,38,2,11,7,1132,28,12,23,30,26,8,38,34,127,35,26,1980,15,10,73,22,13,13,11,91,1,12,3,32,17,14,63,82,34,16,58,5,35,2,29,129,384,13,8,6,35,471,35,23,8,36,44,18,19,38,59,32,8,6,23,34,20,35,7,29,40,23,13,39,23,13,0,14,36,3,6,12,7,67,105,7,7,36,17,41,371,69,13,5,1,8,141,21,26,4,21,18,7,92,160,2,10,15,50,23,21,48,313,42,6,13,9,10,5,47,3,31,5,3,12,38,227,7,742,20,25,15,479,4,41,72,9,28,20,2,67,4,19,6,2,11,1578,4,5,110,13,27,7,1709,33,140,36,32,63,38,24,9,37,695,11,9,3,14,33,5,171,247,14,2236,21,8,10,251,116,17,60,4,1713,25,39,18,302,7,3,10,7,1,86,77,33,9,6,152,65,23,9,19,6,58,15,18,11,15,14,8,632,31,2,3,24,1,5,18,9,0,22,36,23,62,9,4,6,4,24,16,16,4383,6,3,36,27,13,21,12,43,100,16,4,1,18,24,18,28,46,12,3,149,6,110,6,20,10,9,109,22,22,208,3,19,1,27,1,19,11773,6,4655,17,25,12,6,20,148,104,63,1,0,35,207,13,7,6,9,36,0,10,6,2,1,5,2,28,2,1,6,17,13,178,26,9,5,31,99,14,12,6,13,13,152,1,5,4,21,46,202,127,91,69,395,62,133,169,30,10,283,154,66,0,40,7,11,24,4,40,10,12,39,12,3,0,71,22,3,4,2,17,23,2,23,17554,19,1,1,23,20,27,10,0,17,896,15,4,2,5,16,21,13,5,13,4,13,12,2,18,6,12,22,88,7,3,53,4,4,3,77,2,558,13,5,120,0,4,5,51,6,49,3,11,83,15,49,11,1,20,10,15,3,10,54,8,12,14,200,2,5,185,5,3,18,34,3,4,24,85,2,4,109,19,330,2,4,3,12,11,9,11,0,30,13,29,1,32,2,17,4,4,16,2,10,4,6,102,12,9,44,3,2210,12,4,3,4,37,1,10,1,17,2,8,292,157,1,101,3,8,36,10,10,145,1,45,5,0,1,0,12,41,9,9,275,18,1,102,0,1,0,24,49,12,371,14,3,24,28,48,15,89,1,10,2,19,16,151,2,1190,1,7,56,3,7,0,7,4,0,10,146,9,65,81,26,22,52,885,30,53,4,18,55,1,2,7,9,78,40,1,10,1,5,3,35,5,10763,3,67,4,0,8,112,3,253,3,104,10,374,88,3,17,51,5,35,1,16,1,13,7,6,53,20,93,5,27,21,1,72,3,19,2,9,0,6,7,152,2,3,234,69,5,24,254,100,0,17,0,4,18,7,17,10,26,1,2,90,57,23,30,1,6,2,348,5,15,25,0,31,7,21,8,4,4,7,7,10,0,7,4,20,1,146,15,11,9,71,8,3,1,20,12,3,6,2,42,33,15,6,1,18,2,3,54,0,1,18,11,1,1,1,10,32,47,3,38,4,55,0,2,3,4,4,13,29,134,19,9,11,0,2,5,1113,5,0,0,5,4,184,23,3,0,7721,941,1,1,2,2,32,10,1,7,68,4,1,0,45,5,224,3,74,12,2,123,2,5,5,0,0,3,5,90,78,1,4,15,4,9,11,0,14,5,15,0,2,1,9,1,4,1,0,10,2,18,42,4,4,0,4,3,2,20,18,9,0,1,5,4,0,0,2,60,0,36,0,2,1,2,0,3,7,5,56,2,6,1,1,1,13,9,3,159,24,39,3,3,1,13,4,5,4,15,11,9,5,0,9,34,5,1,0,1,10,569,20,4,7,36,121,11,4,3,70,34,7,3,31,4,17,1,0,16,157,0,4,2,0,213,6,0,2,1,25,36,18,5,1,2,0,2,10,2,6,31,0,1,1,32,189,1,3,0,15,3,5,91,72,14,9,15,16,8,17,8,27,1,2447,12,0,3,3,1,9,178,3,26,11,1,12,2,1,6,3,6,101,678,1,8,13,11,3,1,80,0,5,118,0,40,4,10,7,3,4,2,9,1,11,2,8,3,2,7,2,2,5,13,1,269,6,2,59,24,1,1,67,4,10,0,5,0,6,104,3,167,14,12,2,1,22,5,365,0,16,9,40,19,0,0,0,1,0,1,15,0,3,69,2,6992,2,38,5,11,13,5,3,16,0,1,33,5,6,225,5,14,5,38,2,80,9,0,7,0,0,0,4,1,39,1,0,1,13,236,97,38,0,2,3,3,10,1,2,77,2,2,3,6,10,82,12,62,1,0,17,8,8,5,0,57,21,6,2,3,17,4,17,14,0,2,68,9,2,0,3,0,2,0,6,0,22,7,13,39,0,10,3,0,12,1,5,31,8,26,0,1,37,162,2,7,1,1,2,3,10,0,0,5,5988,4,1,0,3,47,4,30,0,35,6,2,2,4,0,2,3,2,100,5,33,7,0,2,2,1,4,0,12,2,14,337,3,119,0,1,3,48,6,0,1,5,2,28,4,9,101,11,6,0,16,3,8,27,6,82,35,4,0,4,2,0,1,1,0,7,72,0,2,0,10,3,0,2,0,0,5,1,2,47,30,1,2,2,0,1,0,31,0,1,5,0,4,5,2,2,1,2,1,2,1,0,7,6,2622,0,1,1,0,4,1,1,0,64,4,3,2,40,2,11,21,18,0,105,12,5,2,0,4,3,0,0,106,3,13,2,133,0,7,3,5,2,1,0,6,7,81,6,3,21,15,0,1,23,1,1,8,0,0,7,12,1,0,9,0,5,3,0,35,2,14,3,0,18,18,24,34,27,0,7,2,0,13,1,1,0,4,2,0,4,9,0,31,0,0,20,1,1,3,6,1,1,4,1,1,0,2,0,1,3,1,204,4,50,2,126,17,4,1,38,2,4,2,18,1,0,6,1,105,2,18,30,2,2,50,1,131,9,3,21,110,1,1,1,1,0,0,13,11,1,2,2,7,3,1,0,5,1,1,65,2,0,0,9,0,3,15,3,1,7,35,1,1,0,6,6,75,0,0,1,16,1,20,5,1,0,8,0,4,3,1,1,1,0,0,1,99,1,188,2,25,1,5,1,14,3,1,0,44,67,1,0,66,34,10,146,15,45,1,0,1,0,0,9,2,3,4,5,37,2,0,6,4,1,1,0,2,0,4,0,1,1,0,118,12,0,1,2,1,0,0,0,0,14,0,2,1,0,15,2,3,0,2,45,15,6,6,1,0,0,3,8,0,0,2,3,1,1,7,2,1,0,1,1,2,1,2,1,4,5,2,3,0,1,5,1,2,1,4,138,11,2,1,2,8,0,3,4,1,36,1,8,5,72,0,4,16,2,1,0,0,0,60,168,8,1,0,1,2,0,4,31,0,1,1,27,28,10,40,1,0,3,5,16,1,0,2,0,10,2,6,3,16,78,0,5,0,7,1,0,0,0,0,0,0,0,4,4,0,62,1,3,14,2,2,28,1,0,3,3578,21,6,2,4,174,3,7,8,17,0,31,11,0,16,2,8,12,85,48,13,6,4,47,12,4,0,2,6,3,0,0,4,0,3,1,0,72,0,1,0,8,1,2,5,2,0,0,6,47,3,1,1,1,5,5,0,2,0,37,1,5,5,0,11,0,0,369,1,1,50,10,2,11,2,1,0,1,24,2,0,10,3,0,9,0,2,1,7,2,1,2,15,1,1,1,81,27,1,1,3,11,4,0,1,0,98,36,1,0,0,1,1,1,7,0,1,3,0,6,0,0,0,0,0,242,0,0,19,1,0,2,0,0,8,5,2,0,38,34,0,1,0,0,3,6,0,36,3,1,0,2,1,0,1,0,25,0,47,12,6,1,0,3,2,6,0,0,21,2,25,0,3,3,0,7,3,2,1,0,32,33,0,0,0,1,0,145,2,1,1,2,8,1,2,0,0,0,7,0,4,0,1,0,2,1,0,22,0,3,0,0,3,10,1,1,13,3,4,2,29,2,3,0,6,0,0,0,1,1,9,2,1,83,154,18,0,3,3,1,1,0,0,1,35,1,0,0,0,44,5,0,19,0,0,2,0,0,0,54,4,0,0,0,8,3,0,3,0,0,0,0,4,35,3,3,49,39,3,0,85,42,0,0,2,7,0,1,23,12,2,41,0,1,3,0,11,12,6,0,1,7,1,2,0,0,2,3,3,0,2,3,1,0,1,3,0,0,5,0,0,0,1,3,2,0,9,0,0,76,0,1,0,2,5,0,0,0,10,2,0,0,48,2,4,4,2,1,0,3,3,1,3,26,3,2,0,2,1,0,0,3,8,6,2,12,1,1,2,0,1,1,2,0,0,1,3,13,8,790,5,5,0,1,2,2,1,1,1,3,0,1,0,0,30,1,0,7,1,1,0,11,3,9,9,0,2,0,0,3,0,0,4,3,2,3,1,0,0,3,1,45,4,1,1,0,12,6,3,0,9,2,1,5,0,1,1,0,0,3,14,0,2,10,0,1,1,2,3,11,2,3,7,0,91,0,1,3,4,0,16,1,1,1,0,7,0,16,11,1,0,1,3,0,0,1,1,0,2,3,159,0,2,107,3,0,0,0,4,9,2,0,2,14,2,0,0,3,18,0,0,5,17,0,1,1,1,3,1,0,2,1,0,9,0,0,0,5,22,2,0,47,6,313,0,1,3,1,0,38,2,1,1,0,31,32,9,0,3,0,0,0,1,0,4,0,25,114,2,0,25,7,1,4,0,5,97,5,0,7,0,1,0,21,0,0,0,1,7,0,3,0,0,7,5,2,0,1,8,0,0,3,6,1,27,5,6,1,0,0,0,0,6,3,12,4,1,8,2,1,9,0,0,3,0,8,2,0,2,3,0,3,0,9,0,1,3,0,0,0,0,1,5,0,0,1,2,69,0,0,0,1,0,6,0,9,23,0,1,9,5,43,15,1,1136,0,2,1,21,0,0,2,10,0,6,1,2,0,0,0,41,3,25,1,20,1,5,20,7,0,1,11,1,1,0,0,1,1,0,0,5,0,0,0,1,0,1,83,68,0,0,1,0,6,2,0,0,17,4,12,13,0,4,63,0,1,0,0,2,0,0,0,3,0,0,0,1,0,0,1,0,443,2,1,1,0,1,0,1,0,2,1,205,0,24,0,32,0,6,5,1,0,6,1,0,0,0,0,0,2,6,10,1,2,0,7,5,37,1,1,3,0,1,1,1,3,16,0,2,0,0,5,5,76,0,133,0,0,1,3,1,1,0,1,1,1,0,0,2,0,1,0,2,0,2,3,0,0,0,0,2,8,2,140,0,6,0,0,19,0,0,0,0,0,4,1,0,0,0,6,1,0,0,0,4,1,0,140,2,2,0,1,0,14,1,0,0,1,1,4,0,15,2,0,0,1,10,2,1,0,1,0,4,216,0,4,2,1,2,1,1,0,1,10,2,2,0,0,8,2,3,0,6,1,0,0,0,0,0,1,0,1,1,0,0,0,2,0,1,0,0,0,0,2,1,0,1,1,1,30,0,0,0,0,3,1,1,3,0,0,0,0,0,0,0,2,0,11,0,2,0,0,4,0,1,0,0,9,0,18,0,0,1,0,0,0,0,0,0,0,2,1,1,21,5,0,0,0,0,0,2,0,5,1,1,0,2,0,1,0,2,2,91,0,1,2,0,24,14,1,10,0,0,5,0,7,0,6,0,0,0,0,1,0,4,19,0,0,7,0,0,1,0,1,0,5,7,0,0,3,2,0,0,21,0,1,0,0,0,0,0,7,0,28,0,1,0,0,2,0,0,1,1,1,12,13,5,0,2,0,0,0,1,1,1,0,2,1,1,0,0,0,1,1,0,0,0,0,2,1,0,25,0,0,2,1,0,0,3,0,0,183,1,6,0,0,0,0,0,0,9,0,1,1,0,0,0,1,1,0,0,0,2,0,0,1,0,2,0,0,0,2,0,7,0,0,0,0,0,0,61,2,0,0,0,0,3,4,4,3,2,0,1,7,0,0,1,167,4,0,1,1,5,1,1,3,0,1,2,0,0,141,0,0,125,0,5,10,1,0,7,2,0,0,1,0,33,1,0,0,0,0,0,0,0,0,3,0,10,0,0,0,0,5,0,1,0,0,0,0,3,0,6,0,0,0,0,7,0,0,12,0,0,1,0,0,0,13,0,0,0,0,0,13,1,8,1,0,1,0,0,5,0,1,1,3,3,4,3,0,77,0,0,13,1,0,4,0,2,2,0,0,0,1,0,571,0,0,0,0,0,0,0,1,1,1,0,0,0,0,2,0,2,0,2,2,0,0,0,0,1,0,0,5,13,3,0,1,0,0,0,0,4,0,9,0,0,0,0,0,0,0,1,5,6,0,0,1,0,0,0,1,0,0,0,0,0,0,3,0,1,0,11,0,0,0,18,1,0,236,7,0,40,1,0,4,0,0,4,0,0,0,0,0,1,0,2,1,0,4,2,1,0,0,0,35,387,0,0,0,1,19,1,0,0,2,0,5,1,0,0,0,1,0,0,1,1,0,0,2,1,3,0,0,0,0,0,0,0,0,0,7,2,0,0,0,0,0,0,1,0,1,0,0,6,0,0,1,2,1,2,0,1,0,0,7,0,1,1,0,2,2,1,0,0,0,1,1,0,0,1,3,0,0,3,0,3,2,0,3,0,0,3,0,0,1,1,11,8,12,0,1,0,0,0,0,0,1,2,0,0,0,58,1,0,0,4,1,0,7,0,0,1,1,0,0,0,0,0,0,1,0,0,0,0,1,0,0,0,0,0,0,0,1,0,0,0,0,2,1,0,0,0,0,1,0,0,4,1,0,2,0,4,1,6,2,0,1,7,0,0,0,0,2,23,0,0,2,2,1,0,3,0,0,0,0,4,0,5,9,3,1,0,0,1,13,4,0,1,0,0,1,0,0,0,0,3,2,1,0,2,0,0,1,0,0,0,0,0,0,0,0,0,1,0,0,2,0,0,1,1,0,4,1,0,1,0,1,3,0,0,0,34,0,0,3,0,0,1,1,2,0,0,6,0,0,0,0,0,0,0,0,28,1,0,46,4,0,0,2,0,0,2,0,0,0,1,1,0,1,0,0,0,0,0,0,0,0,0,1,0,0,0,0,0,0,0,0,0,0,1,0,1,0,0,0,0,0,0,0,1,2,1,0,0,0,0,0,1,6,0,18,2,63,1,1,0,0,0,0,0,0,0,0,0,0,0,2,0,8,0,0,7,0,0,1,1,1,3,0,13,0,2,0,0,0,0,0,0,0,0,1,0,0,0,0,0,1,0,0,0,0,0,0,0,1,0,1,0,0,0,0,0,0,0,0,0,1,2,0,6,0,0,1,1,2,0,0,0,0,0,0,0,0,0,0,0,0,0,0,0,2,0,0,2,0,0,2,0,0,1,0,0,0,0,0,1,1,4,1,0,0,1,0,0,0,0,1,0,0,0,1,0,0,0,0,0,0,1,0,4,0,5,2,1,0,0,1,1,0,0,0,0,0,0,0,1,0,0,0,0,0,0,0,0,0,0,0,0,0,0,0,1,0,2,0,0,0,2,0,0,0,0,0,0,3,0,0,0,0,0,0,0,4,25,1,0,0,0,0,0,1,0,0,1,0,0,0,1,0,0,2,0,1,0,0,0,1,0,1,0,0,0,0,0,0,0,0,0,0,0,0,0,1,0,0,0,0,0,0,0,0,0,0,0,3,0,0,0,1,0,0,0,0,0,4,0,0,1,0,0,0,0,0,0,0,0,0,0,0,0,0,0,2,0,0,0,0,0,0,0,0,0,0,1,0,0,0,0,0,0,0,0,0,0,0,0,0,6,0,0,0,0,0,0,0,12,0,1,0,0,0,1,0,0,0,0,0,0,0,0,0,0,0,0,0,0,20,0,0,0,0,0,0,0,0,0,0,0,0,0,2,0,0,2,9,1,0,0,1,0,0,0,0,0,0,0,1,0,0,0,0,0,0,0,0,0,0,2,0,0,0,1,0,1,0,0,0,0,0,0,0,0,0,0,0,0,0,0,0,0,0,0,0,0,0,0,0,0,0,1,2,0,2,0,0,0,0,0,0,0,0,0,0,0,0,0,0,0,0,0,0,0,0,0,0,0,2,0,0,0,20,0,0,3,0,0,0,0,0,0,0,0,0,0,0,0,0,0,0,0,0,0,0,0,0,0
"Uterine Carcinosarcoma",32,6,13,232,0,37,4,0,9,4,0,3,0,1,2,0,21,5,1,1,3,0,157,4,0,0,4,0,5,0,3,24,1,0,2,2,0,0,5,0,36,1108,1,0,0,2,0,0,10,0,0,1,0,7,0,0,1,1,4,5,29,3,0,0,122,0,17,4,0,0,0,1,0,0,2,0,0,7,0,4,9,28,9,6,35,0,3,0,0,0,1,11,3,1,13,0,1,2,0,3,1,2,23,0,0,0,2,3,0,70,0,0,2,0,2,0,1,0,0,0,0,0,0,6,0,2,54,0,1,0,0,6,11,0,4,1,2,2,8,0,0,4,1,2,0,1,0,0,0,0,16,0,9,0,3,0,1,2,1,0,0,0,0,0,0,0,29,0,1,0,7,0,0,0,0,2,0,0,2,0,0,16,18,0,0,0,2,0,0,0,2,0,1,1,0,1,1,0,2,1,0,0,0,0,0,1,2,19,0,29,0,0,77,0,0,1,0,0,1,0,1,0,0,0,0,0,0,13,1,0,2,2,1,0,0,0,2,21,0,0,2,0,5,0,0,2,1,0,0,0,2,0,1,0,5,15,0,3,0,3,2,0,0,13,23,2,7,0,2,0,0,0,0,1,0,0,0,0,0,18,2,0,0,0,0,0,0,0,0,0,0,0,9,1,0,2,0,0,0,0,1,0,2,2,0,2,1,0,2,0,0,0,12,1,0,0,0,0,57,0,1,0,1,0,0,5,0,0,0,0,0,0,0,0,0,0,0,0,0,5,1,0,0,2,1,0,0,1,0,0,0,0,0,0,0,0,0,0,0,1,0,0,0,0,0,3,0,2,0,0,0,30,0,5,0,0,0,0,0,0,2,1,0,0,0,0,0,8,0,0,0,1,0,0,0,1,0,0,19,0,1,0,0,0,0,0,0,3,11,0,0,0,0,6,0,0,0,0,19,0,0,0,0,0,0,0,0,0,0,0,0,0,0,0,0,0,0,0,0,0,0,0,0,0,0,0,3,0,0,0,0,1,7,2,0,0,0,0,4,0,0,0,0,0,0,1,15,0,0,0,0,0,0,0,0,2,0,0,0,0,0,0,0,3,0,0,0,34,0,0,15,0,1,0,6,0,0,1,0,0,0,0,0,0,0,0,0,0,11,0,0,54,0,0,0,0,0,0,0,0,0,0,0,0,0,25,0,0,0,0,0,0,3,14,2,1,0,0,1,4,5,0,0,0,11,0,0,0,1,0,0,0,0,0,0,0,0,0,0,0,0,0,0,0,0,2,0,0,0,0,0,0,2,2,0,0,4,0,0,0,0,0,2,0,0,0,2,0,0,0,0,0,0,0,0,0,0,0,0,0,0,0,18,0,0,0,1,0,0,0,0,1,0,0,0,3,0,0,0,0,5,0,2,4,0,0,0,0,0,0,47,0,14,0,0,0,0,0,0,1,2,0,0,0,15,1,1,0,0,1,1,0,0,0,0,1,0,0,0,0,1,5,0,0,1,1,0,0,0,0,0,0,0,0,14,0,2,0,1,0,0,1,1,0,1,0,0,3,0,0,1,0,0,0,1,0,0,0,0,1,3,0,0,0,0,0,0,0,0,0,0,0,0,0,0,8,0,0,0,0,0,0,0,0,0,1,0,0,0,0,1,0,0,0,0,0,0,0,0,7,0,0,0,1,0,0,0,0,0,0,0,0,2,0,0,1,0,0,0,0,0,0,1,0,0,1,0,5,3,0,0,1,0,0,2,0,2,0,20,0,0,50,0,0,0,0,0,0,0,1,0,0,24,0,0,0,0,0,0,0,0,0,0,1,0,0,0,0,0,0,0,0,0,0,0,0,0,1,0,0,0,0,0,0,0,0,0,0,0,0,0,2,0,0,1,2,0,1,0,0,0,0,0,10,0,0,0,0,0,0,0,1,0,0,0,0,0,19,0,0,0,1,0,0,0,0,0,0,0,1,0,0,0,0,0,1,0,0,0,0,0,0,0,0,0,0,0,0,0,0,206,0,0,0,0,1,0,2,0,0,0,0,0,0,0,0,0,0,0,1,0,0,0,0,1,0,0,0,0,0,0,0,25,0,0,0,0,0,15,1,0,3,0,0,0,0,0,0,1,0,0,2,0,1,0,0,1,0,4,0,0,0,0,0,0,0,0,0,0,1,0,0,0,0,3,0,0,0,0,0,0,0,0,1,0,0,0,1,0,0,0,0,0,0,0,0,0,0,0,0,0,0,1,0,0,0,0,0,0,0,2,0,0,0,0,0,3,0,0,0,0,0,0,0,0,0,1,0,0,0,0,0,0,0,0,0,2,0,0,0,0,0,0,0,0,0,0,3,0,0,0,0,0,0,1,0,0,0,0,0,0,0,0,0,0,0,0,0,21,0,0,0,0,0,0,0,0,0,0,0,0,0,0,0,0,0,0,1,1,0,0,0,0,7,0,0,0,0,0,0,0,3,1,0,0,0,0,0,0,0,0,0,0,0,0,0,0,0,0,0,0,0,0,0,0,0,0,0,0,0,0,0,2,0,0,0,0,0,0,0,0,70,0,0,0,0,0,0,0,0,0,0,1,0,0,0,0,0,0,0,0,5,1,0,0,0,3,3,0,0,0,0,0,0,0,0,0,0,0,0,0,0,0,1,0,0,0,0,0,0,0,0,3,0,0,0,1,0,1,0,0,0,4,0,0,0,0,0,0,0,0,0,0,0,0,0,0,0,0,0,0,0,0,0,0,0,0,0,0,0,0,0,0,0,0,3,6,0,0,0,0,0,1,0,0,0,0,0,0,0,0,0,0,2,3,0,1,0,0,0,0,0,0,0,3,0,0,0,0,0,0,0,0,0,0,0,0,1,0,0,0,0,1,0,0,0,0,0,0,0,0,0,0,0,0,0,0,87,0,1,0,0,0,0,2,0,0,0,0,0,0,1388,0,0,0,0,0,0,0,0,1,0,0,0,0,0,0,0,0,0,0,0,0,0,5,0,0,0,0,0,0,0,0,0,0,0,0,1,1,0,0,0,0,0,0,31,0,3,0,0,0,0,0,0,0,0,1,0,0,0,0,0,5,0,0,0,0,0,0,0,0,12,0,0,0,0,0,0,0,0,0,0,0,1,0,4,0,157,0,0,0,0,0,0,0,0,0,0,2,0,2,0,0,0,0,0,0,0,0,0,0,0,0,0,0,0,0,0,0,11,0,2,0,0,2,0,0,0,1,0,0,0,3,0,0,0,0,0,0,0,0,0,0,0,0,0,0,1,0,0,0,0,0,0,2,0,0,0,0,0,0,0,0,0,0,0,0,0,0,16,0,0,0,2,0,0,0,0,0,0,0,0,0,0,1,0,0,0,0,0,0,0,0,1,0,0,0,0,0,0,0,0,3,0,0,0,0,0,0,0,0,0,0,0,0,0,0,0,0,0,0,0,0,66,0,0,0,0,1,2,0,0,0,0,0,0,0,0,0,0,0,0,0,0,0,0,0,0,0,0,0,0,0,0,0,0,0,0,0,0,0,0,1,0,0,0,0,0,0,0,0,0,0,0,0,0,0,0,0,0,0,0,4,0,0,0,0,0,0,0,0,0,0,0,0,0,0,0,0,0,0,0,1,0,0,0,0,0,0,0,0,0,0,0,0,1,0,0,0,0,0,0,0,0,0,0,0,0,0,0,0,1,0,0,0,0,0,0,0,0,0,0,0,0,0,0,0,0,0,0,0,0,0,0,0,1,0,0,0,0,0,0,0,0,0,0,0,0,0,0,3,0,0,0,0,0,150,0,0,1,0,0,0,0,0,0,0,0,0,0,0,0,0,0,0,1,0,0,0,0,0,0,0,0,1,0,0,0,0,0,0,0,1,0,0,0,0,0,1,0,0,0,0,0,0,0,0,0,0,0,0,0,2,0,0,0,0,0,0,0,1,0,0,0,0,0,0,0,0,0,0,12,0,5,0,0,0,0,0,0,0,0,0,0,0,0,0,0,0,0,0,0,0,0,0,0,0,0,0,0,0,0,0,0,0,0,0,0,0,0,0,0,0,0,2,0,0,0,0,0,0,0,0,0,0,0,0,0,0,0,0,0,0,0,0,0,0,0,0,0,0,0,0,0,0,0,0,0,0,0,0,0,0,0,0,0,0,0,0,0,0,0,0,0,0,3,0,0,0,1,0,0,0,0,0,0,0,0,9,0,0,0,0,0,0,0,0,5,0,0,0,0,0,0,0,0,0,0,0,0,0,0,0,0,0,0,0,1,0,1,0,0,0,0,0,0,0,0,0,0,0,0,0,0,0,2,0,0,0,0,0,0,0,0,0,0,0,0,0,0,1,0,6,0,0,0,0,0,0,0,0,0,0,0,0,0,0,0,0,0,0,0,0,0,0,0,0,9,0,0,0,0,0,0,0,0,0,0,0,0,0,0,0,0,0,0,0,0,0,0,0,0,0,0,9,0,0,0,0,0,0,0,0,0,0,0,0,0,1,0,0,0,0,0,0,0,0,0,0,0,0,0,0,0,0,0,0,0,0,0,0,0,0,0,0,0,10,0,0,0,0,0,0,0,0,0,0,0,0,0,0,0,0,0,0,0,0,0,0,0,4,0,0,0,0,0,0,0,0,0,0,0,0,3,0,0,0,0,0,0,0,0,14,0,0,0,0,0,0,1,0,0,0,0,0,0,0,0,0,0,0,0,0,0,0,0,0,0,0,0,0,0,0,0,0,1,0,0,0,0,0,2,1,0,0,0,0,0,0,0,0,0,0,0,0,1,0,0,0,0,0,0,0,0,0,0,0,0,0,0,0,26,0,0,0,0,0,0,0,0,0,0,0,0,0,0,0,0,0,0,0,0,0,0,0,0,0,0,0,0,0,0,0,0,0,1,0,0,0,0,0,0,1,0,2,0,0,0,0,0,0,0,0,0,0,0,0,0,0,0,0,0,0,0,0,0,0,0,0,0,0,0,0,1,7,0,0,0,0,0,0,0,1,0,0,0,0,0,0,0,0,0,0,0,0,0,0,0,0,0,0,0,0,0,0,0,0,0,0,0,0,0,0,0,0,0,0,0,0,0,0,0,0,0,1,0,1,0,0,0,0,0,0,0,0,0,0,0,1,0,0,0,0,0,0,0,0,0,0,0,0,0,0,0,0,0,0,0,0,0,0,0,1,0,0,0,0,0,0,0,0,0,0,0,0,0,0,0,0,11,0,0,0,0,0,0,9,0,0,0,0,0,0,0,0,0,0,0,0,0,0,0,0,0,0,0,34,0,0,0,0,0,2,0,0,0,0,1,0,0,0,0,0,0,0,0,0,0,0,0,0,0,0,0,0,0,0,6,0,0,0,0,0,0,0,0,0,0,0,0,0,0,1,0,0,0,0,0,0,0,0,0,0,0,0,0,0,0,0,0,0,0,0,0,0,0,0,0,1,0,0,0,0,0,0,0,0,2,0,0,0,0,0,0,0,0,0,0,0,0,0,0,0,10,0,0,0,0,1,0,0,0,0,0,0,0,0,0,0,0,0,0,0,0,0,0,0,0,0,0,0,0,0,0,0,0,0,0,0,0,0,0,0,0,0,0,0,0,0,0,0,0,0,0,0,0,0,0,0,0,0,0,0,0,0,0,0,0,0,23,0,0,0,0,0,0,0,0,0,0,0,0,0,0,0,0,0,0,0,0,0,2,0,0,0,0,0,0,2,0,2,0,0,0,0,0,0,1,0,0,0,0,0,0,0,0,0,0,0,0,0,0,0,0,0,0,2,0,0,0,0,0,0,1,0,0,0,0,0,0,0,0,0,0,0,0,0,0,0,0,0,0,0,0,0,0,0,0,0,0,0,0,0,0,0,0,0,0,0,0,0,0,0,0,0,0,0,0,0,0,0,0,0,0,3,0,0,0,0,0,0,0,0,0,0,0,0,0,0,0,0,1,0,0,0,0,0,0,0,0,0,0,0,0,0,0,0,0,0,0,0,0,0,0,0,0,0,0,0,0,0,0,0,0,0,0,148,0,0,0,0,0,0,0,0,0,0,0,0,0,0,0,0,0,0,0,0,0,3,0,0,0,0,0,0,0,0,0,0,0,0,0,0,0,0,0,0,0,0,0,0,0,0,0,0,0,2,0,0,0,0,0,0,0,0,0,0,0,0,0,0,0,0,0,0,0,0,0,0,0,0,0,0,0,0,0,0,0,0,0,0,0,0,0,0,0,0,0,0,0,0,0,0,0,0,0,0,0,0,0,0,0,0,0,0,0,0,0,0,0,0,0,0,0,0,0,0,0,0,0,0,0,0,0,0,0,0,0,0,0,0,0,0,0,0,0,0,0,0,0,0,0,0,0,0,0,0,0,0,0,0,0,0,0,0,0,0,0,0,0,0,0,0,0,0,0,0,0,0,0,0,0,0,0,0,0,0,0,0,0,1,0,0,0,0,0,0,0,0,1,0,0,0,0,0,0,0,0,0,0,0,0,0,0,0,0,0,0,0,0,0,0,7,0,0,0,0,0,3,0,0,0,0,0,0,0,0,0,0,0,0,0,0,0,0,0,0,0,0,0,0,0,0,0,0,0,0,0,0,0,0,0,0,0,0,0,0,0,0,0,0,0,0,0,0,0,0,0,0,0,0,0,0,0,0,0,0,0,0,0,0,0,0,0,1,0,0,0,0,0,0,0,0,0,0,0,0,0,0,0,0,0,0,0,0,0,0,0,0,0,0,0,0,0,0,0,0,0,0,0,0,0,0,0,0,0,0,0,0,0,0,0,0,0,0,0,0,0,1,1,0,0,0,0,0,0,0,0,0,0,0,0,0,0,0,0,0,0,0,0,0,0,0,0,0,0,0,0,0,0,0,0,0,0,0,0,0,0,0,0,0,0,0,0,0,133,0,0,0,0,0,3,0,0,0,0,0,0,0,0,0,0,0,0,0,0,0,0,0,0,0,0,0,0,0,0,0,0,0,0,0,0,3,0,0,0,0,0,0,0,0,0,0,0,0,0,0,0,1,0,0,0,0,0,0,0,0,0,0,0,0,0,0,0,0,0,0,0,1,0,0,0,0,0,0,0,0,0,0,0,0,0,0,0,0,0,0,0,0,0,0,0,0,0,0,0,0,0,0,0,0,0,0,0,0,0,0,0,0,0,0,0,0,0,0,0,0,5,6,0,0,0,0,0,0,0,0,0,0,0,0,0,0,0,0,0,0,0,0,0,0,0,0,0,0,0,0,0,0,0,0,0,0,0,0,0,0,0,0,0,0,0,0,0,0,0,0,0,0,0,0,0,0,0,1,0,0,0,0,0,0,0,0,0,0,0,0,0,0,0,0,0,0,0,0,0,0,0,0,0,0,0,0,0,0,0,0,0,0,0,0,0,0,0,0,0,1,0,0,0,0,0,0,0,0,0,0,0,0,1,0,0,0,0,0,0,0,0,0,0,0,0,0,0,0,0,0,0,0,0,0,0,0,0,0,0,0,0,0,0,0,0,0,0,0,0,0,0,0,0,0,0,0,0,0,0,0,0,0,0,0,0,0,0,0,0,0,0,0,0,0,67,0,0,0,0,0,0,0,0,0,0,0,0,0,0,0,0,0,0,0,0,0,0,0,0,0,0,0,0,0,0,0,0,0,0,0,0,0,0,0,0,0,0,0,0,0,0,0,0,0,0,0,0,0,0,0,0,0,0,0,0,0,0,0,0,0,0,0,0,0,0,0,0,0,0,0,0,0,0,0,0,0,0,0,0,0,0,0,0,0,0,0,0,0,0,1,0,0,0,0,0,0,0,0,0,0,0,0,0,0,1,0,0,0,0,0,0,0,0,0,0,0,0,0,0,0,0,0,0,0,0,0,0,0,0,0,0,0,0,0,0,0,0,0,0,0,0,0,0,0,0,0,0,0,0,0,0,0,0,0,0,0,0,0,0,0,0,0,0,0,0,0,0,0,0,0,0,0,0,0,0,0,0,0,0,0,1,0,0,0,0,0,0,0,0,0,0,0,0,0,0,0,0,0,0,0,0,0,0,0,0,0,0,0,0,0,0,0,0,0,0,0,0,0,0,0,0,0,0,0,0,0,0,0,0,0,0,0,0,0,0,0,0,0,0,56,0,0,0,0,0,0,0,0,0,0,0,0,0,0,0,0,0,0,0,0,0,0,0,0,0,0,0,0,0,0,0,0,0,0,0,0,0,0,0,0,0,0,0,0,0,0,0,0,0,0,0,1,0,0,0,0,0,0,0,0,0,0,0,0,0,0,0,0,0,0,0,0,0,0,0,0,0,0,0,0,0,0,0,0,0,0,0,0,0,0,0,0,0,0,0,0,0,0,0,0,0,0,0,0,0,0,0,0,0,0,0,0,0,0,0,0,0,0,0,0,0,0,0,0,0,0,0,0,0,0,0,0,0,0,0,0,0,0,0,0,0,0,0,0,0,0,0,0,0,0,0,0,0,0,0,0,0,0,0,0,0,0,0,0,0,1,0,0,0,0,0,0,0,0,0,0,0,0,0,0,0,0,0,0,0,0,0,0,0,0,0,0,0,0,0,0,0,0,0,0,0,0,0,1,0,0,0,0,0,0,0,0,0,0,0,0,0,0,0,0,0,0,0,0,0,0,0,0,0,0,0,0,0,0,0,0,0,0,0,0,0,0,0,0,0,0,0,0,0,0,0,0,0,0,0,0,0,0,0,0,0,0,0,0,0,0,0,0,0,0,0,0,0,0,0,0,0,0,0,0,0,0,0,0,0,0,0,0,0,0,0,0,0,0,0,0,0,0,0,0,0,0,0,0,0,0,0,0,0,0,0,0,0,0,0,0,0,0,0,0,0,0,0,0,0,0,0,0,0,0,0,0,0,0,0,0,0,0,0,0,0,0,0,0,0,0,0,0,0,0,0,0,0,0,0,0,0,0,0,0,0,0,0,0,0,0,0,0,0,0,0,0,0,0,0,0,0,0,0,0,0,0,0,0,0,0,0,0,0,0,0,0,0,0,0,0,0,0,0,0,0,0,0,0,0
